İl Kodu,Province,Work_Accident_Male,Work_Accident_Female,Occupational_Disease_Male,Occupational_Disease_Female,Fatality_Accident_Male,Fatality_Accident_Female,Fatality_Disease_Male,Fatality_Disease_Female,Year,Total_Work_Accidents,Total_Occupational_Diseases,Total_Fatalities_Accidents,Total_Fatalities_Diseases
1,Adana,11443,2072,5,0,49,1,0,0,2024,13515,5,50,0
2,Adıyaman,2466,197,1,0,19,0,0,0,2024,2663,1,19,0
3,Afyonkarahisar,2272,659,2,0,11,1,0,0,2024,2931,2,12,0
4,Ağrı,224,49,0,0,5,0,0,0,2024,273,0,5,0
5,Amasya,1405,255,0,0,3,0,0,0,2024,1660,0,3,0
6,Ankara,37447,12895,26,2,142,4,0,0,2024,50342,28,146,0
7,Antalya,30679,17092,2,2,69,7,0,0,2024,47771,4,76,0
8,Artvin,340,54,0,0,9,0,0,0,2024,394,0,9,0
9,Aydın,7470,2923,2,0,20,1,0,0,2024,10393,2,21,0
10,Balıkesir,5250,1962,2,1,39,8,0,0,2024,7212,3,47,0
11,Bilecik,3956,1220,15,0,8,0,0,0,2024,5176,15,8,0
12,Bingöl,328,70,0,0,2,0,0,0,2024,398,0,2,0
13,Bitlis,320,115,0,0,0,0,0,0,2024,435,0,0,0
14,Bolu,2987,1619,3,0,7,0,0,0,2024,4606,3,7,0
15,Burdur,828,279,0,0,12,0,0,0,2024,1107,0,12,0
16,Bursa,27236,10185,25,14,85,1,2,0,2024,37421,39,86,2
17,Çanakkale,2754,828,1,0,12,2,0,0,2024,3582,1,14,0
18,Çankırı,1012,224,0,0,4,0,0,0,2024,1236,0,4,0
19,Çorum,2316,602,6,0,8,0,0,0,2024,2918,6,8,0
20,Denizli,7714,2664,3,0,20,2,0,0,2024,10378,3,22,0
21,Diyarbakır,3138,606,1,0,30,0,0,0,2024,3744,1,30,0
22,Edirne,1498,718,0,0,1,0,0,0,2024,2216,0,1,0
23,Elazığ,1404,267,0,0,12,0,0,0,2024,1671,0,12,0
24,Erzincan,495,144,0,0,7,0,0,0,2024,639,0,7,0
25,Erzurum,1833,385,0,0,6,1,0,0,2024,2218,0,7,0
26,Eskişehir,7990,3173,14,2,18,0,0,0,2024,11163,16,18,0
27,Gaziantep,14296,1522,2,0,64,1,0,0,2024,15818,2,65,0
28,Giresun,1080,441,0,0,6,0,0,0,2024,1521,0,6,0
29,Gümüşhane,171,47,0,0,3,0,0,0,2024,218,0,3,0
30,Hakkari,159,10,0,0,2,0,0,0,2024,169,0,2,0
31,Hatay,6360,453,1,0,50,0,0,0,2024,6813,1,50,0
32,Isparta,1074,425,1,0,6,0,0,0,2024,1499,1,6,0
33,Mersin,17396,1620,3,0,58,2,1,0,2024,19016,3,60,1
34,İstanbul,111940,43029,187,88,309,8,0,0,2024,154969,275,317,0
35,İzmir,40607,14094,38,6,106,6,0,0,2024,54701,44,112,0
36,Kars,129,22,0,0,2,0,0,0,2024,151,0,2,0
37,Kastamonu,1464,319,1,0,3,0,0,0,2024,1783,1,3,0
38,Kayseri,14492,2624,5,1,33,2,0,0,2024,17116,6,35,0
39,Kırklareli,2657,937,2,1,13,0,0,0,2024,3594,3,13,0
40,Kırşehir,1494,154,1,0,4,0,0,0,2024,1648,1,4,0
41,Kocaeli,35994,10897,76,43,70,2,0,0,2024,46891,119,72,0
42,Konya,13549,3530,4,0,53,0,0,0,2024,17079,4,53,0
43,Kütahya,4517,1388,17,2,19,0,0,0,2024,5905,19,19,0
44,Malatya,3305,500,1,0,20,0,0,0,2024,3805,1,20,0
45,Manisa,16123,6566,14,2,34,0,0,0,2024,22689,16,34,0
46,Kahramanmaraş,5049,762,0,0,29,1,0,0,2024,5811,0,30,0
47,Mardin,658,68,0,0,16,0,0,0,2024,726,0,16,0
48,Muğla,8552,3556,1,0,28,2,0,0,2024,12108,1,30,0
49,Muş,137,68,0,0,2,0,0,0,2024,205,0,2,0
50,Nevşehir,1138,418,0,0,5,0,0,0,2024,1556,0,5,0
51,Niğde,1270,279,1,0,6,0,0,0,2024,1549,1,6,0
52,Ordu,1908,741,3,0,5,0,0,0,2024,2649,3,5,0
53,Rize,844,195,0,0,1,0,0,0,2024,1039,0,1,0
54,Sakarya,10436,3635,25,6,17,1,0,0,2024,14071,31,18,0
55,Samsun,5552,1559,8,0,16,0,0,0,2024,7111,8,16,0
56,Siirt,350,15,0,0,1,0,0,0,2024,365,0,1,0
57,Sinop,574,157,0,0,6,0,0,0,2024,731,0,6,0
58,Sivas,3529,487,0,1,14,0,0,0,2024,4016,1,14,0
59,Tekirdağ,16473,6282,18,6,38,1,0,0,2024,22755,24,39,0
60,Tokat,1150,467,4,26,10,0,0,0,2024,1617,30,10,0
61,Trabzon,2309,620,1,0,24,0,0,0,2024,2929,1,24,0
62,Tunceli,76,13,0,0,1,0,0,0,2024,89,0,1,0
63,Şanlıurfa,1882,202,1,0,23,0,0,0,2024,2084,1,23,0
64,Uşak,2886,1272,1,0,6,0,0,0,2024,4158,1,6,0
65,Van,981,493,0,0,10,0,0,0,2024,1474,0,10,0
66,Yozgat,1209,330,0,0,7,0,0,0,2024,1539,0,7,0
67,Zonguldak,8827,570,22,0,18,0,0,0,2024,9397,22,18,0
68,Aksaray,2142,279,0,0,11,0,0,0,2024,2421,0,11,0
69,Bayburt,178,66,0,0,3,0,0,0,2024,244,0,3,0
70,Karaman,1893,1018,0,0,3,0,0,0,2024,2911,0,3,0
71,Kırıkkale,1794,277,0,0,2,0,0,0,2024,2071,0,2,0
72,Batman,730,155,0,0,10,0,0,0,2024,885,0,10,0
73,Şırnak,491,17,0,0,18,0,0,0,2024,508,0,18,0
74,Bartın,1699,376,1,0,8,0,0,0,2024,2075,1,8,0
75,Ardahan,57,19,0,0,0,0,0,0,2024,76,0,0,0
76,Iğdır,130,25,1,0,3,0,0,0,2024,155,1,3,0
77,Yalova,11159,533,9,1,12,0,0,0,2024,11692,10,12,0
78,Karabük,2229,239,1,0,4,0,0,0,2024,2468,1,4,0
79,Kilis,543,89,0,0,2,0,0,0,2024,632,0,2,0
80,Osmaniye,2231,307,0,1,18,0,0,0,2024,2538,1,18,0
81,Düzce,4252,1292,6,3,13,0,0,0,2024,5544,9,13,0
1,Adana,10313,1618,3,0,44,1,0,0,2023,11931,3,45,0
2,Adıyaman,1056,153,0,0,10,1,0,0,2023,1209,0,11,0
3,Afyonkarahisar,1928,483,0,0,10,0,0,0,2023,2411,0,10,0
4,Ağrı,201,43,0,0,2,0,0,0,2023,244,0,2,0
5,Amasya,1483,215,0,0,9,0,0,0,2023,1698,0,9,0
6,Ankara,35980,10805,20,3,145,3,0,0,2023,46785,23,148,0
7,Antalya,27456,14224,2,0,77,4,0,0,2023,41680,2,81,0
8,Artvin,349,58,1,0,5,0,0,0,2023,407,1,5,0
9,Aydın,6970,2312,1,0,29,0,0,0,2023,9282,1,29,0
10,Balıkesir,5015,1562,2,1,33,2,0,0,2023,6577,3,35,0
11,Bilecik,4201,1164,4,0,11,0,0,0,2023,5365,4,11,0
12,Bingöl,315,58,0,0,2,0,0,0,2023,373,0,2,0
13,Bitlis,305,90,0,0,1,0,0,0,2023,395,0,1,0
14,Bolu,3060,1581,3,0,7,3,0,0,2023,4641,3,10,0
15,Burdur,849,204,0,0,5,0,0,0,2023,1053,0,5,0
16,Bursa,27583,9221,14,3,63,6,0,0,2023,36804,17,69,0
17,Çanakkale,2654,778,3,0,8,1,0,0,2023,3432,3,9,0
18,Çankırı,944,220,2,0,3,0,0,0,2023,1164,2,3,0
19,Çorum,2054,420,1,0,15,0,0,0,2023,2474,1,15,0
20,Denizli,7419,2230,4,0,21,3,0,0,2023,9649,4,24,0
21,Diyarbakır,2653,482,2,0,30,0,0,0,2023,3135,2,30,0
22,Edirne,1409,627,0,0,7,0,0,0,2023,2036,0,7,0
23,Elazığ,1315,261,0,0,16,1,0,0,2023,1576,0,17,0
24,Erzincan,500,112,1,0,2,0,0,0,2023,612,1,2,0
25,Erzurum,1834,275,0,0,7,0,0,0,2023,2109,0,7,0
26,Eskişehir,8178,2858,11,1,24,1,0,0,2023,11036,12,25,0
27,Gaziantep,12890,1120,2,0,52,0,0,0,2023,14010,2,52,0
28,Giresun,1038,348,1,0,8,0,0,0,2023,1386,1,8,0
29,Gümüşhane,175,31,0,0,1,0,0,0,2023,206,0,1,0
30,Hakkari,163,12,0,0,0,0,0,0,2023,175,0,0,0
31,Hatay,3986,298,4,0,53,4,0,0,2023,4284,4,57,0
32,Isparta,1086,338,0,0,14,0,0,0,2023,1424,0,14,0
33,Mersin,16097,1119,3,1,63,0,0,0,2023,17216,4,63,0
34,İstanbul,110201,37858,182,99,330,12,0,0,2023,148059,281,342,0
35,İzmir,40958,12177,36,6,102,4,0,0,2023,53135,42,106,0
36,Kars,127,22,1,0,2,0,0,0,2023,149,1,2,0
37,Kastamonu,1471,215,0,0,7,0,0,0,2023,1686,0,7,0
38,Kayseri,14178,2212,5,0,32,0,0,0,2023,16390,5,32,0
39,Kırklareli,2551,803,9,0,17,0,0,0,2023,3354,9,17,0
40,Kırşehir,1377,94,0,0,3,0,0,0,2023,1471,0,3,0
41,Kocaeli,34757,10026,114,60,66,2,0,0,2023,44783,174,68,0
42,Konya,12617,2728,5,0,66,0,0,0,2023,15345,5,66,0
43,Kütahya,4393,972,9,2,13,0,0,0,2023,5365,11,13,0
44,Malatya,2579,420,1,0,14,0,0,0,2023,2999,1,14,0
45,Manisa,17401,6196,13,1,38,2,0,0,2023,23597,14,40,0
46,Kahramanmaraş,3678,394,1,0,60,1,0,0,2023,4072,1,61,0
47,Mardin,653,89,0,0,20,0,0,0,2023,742,0,20,0
48,Muğla,7974,3129,5,1,30,1,0,0,2023,11103,6,31,0
49,Muş,160,53,0,0,5,0,0,0,2023,213,0,5,0
50,Nevşehir,914,243,1,0,12,0,0,0,2023,1157,1,12,0
51,Niğde,1072,207,0,0,11,0,0,0,2023,1279,0,11,0
52,Ordu,1693,572,0,0,8,0,0,0,2023,2265,0,8,0
53,Rize,810,170,0,0,6,0,0,0,2023,980,0,6,0
54,Sakarya,10160,3429,14,1,18,2,0,0,2023,13589,15,20,0
55,Samsun,5049,1134,4,2,20,1,0,0,2023,6183,6,21,0
56,Siirt,355,8,0,0,6,0,0,0,2023,363,0,6,0
57,Sinop,440,108,0,0,1,0,0,0,2023,548,0,1,0
58,Sivas,3440,439,2,0,9,0,0,0,2023,3879,2,9,0
59,Tekirdağ,16446,5700,15,6,31,1,0,0,2023,22146,21,32,0
60,Tokat,1282,501,0,5,6,0,0,0,2023,1783,5,6,0
61,Trabzon,2127,496,0,0,17,0,0,0,2023,2623,0,17,0
62,Tunceli,67,7,0,0,0,0,0,0,2023,74,0,0,0
63,Şanlıurfa,1470,170,0,0,18,0,0,0,2023,1640,0,18,0
64,Uşak,2879,1088,1,0,8,0,0,0,2023,3967,1,8,0
65,Van,879,244,0,0,13,0,0,0,2023,1123,0,13,0
66,Yozgat,850,208,0,0,6,0,0,0,2023,1058,0,6,0
67,Zonguldak,8135,524,45,1,11,1,0,0,2023,8659,46,12,0
68,Aksaray,1902,193,1,0,14,1,0,0,2023,2095,1,15,0
69,Bayburt,179,35,0,0,1,0,0,0,2023,214,0,1,0
70,Karaman,1639,882,0,0,12,0,0,0,2023,2521,0,12,0
71,Kırıkkale,1326,148,0,0,4,0,0,0,2023,1474,0,4,0
72,Batman,716,137,1,0,14,0,0,0,2023,853,1,14,0
73,Şırnak,467,14,0,0,22,0,0,0,2023,481,0,22,0
74,Bartın,1550,250,0,0,5,0,0,0,2023,1800,0,5,0
75,Ardahan,63,11,0,0,3,0,0,0,2023,74,0,3,0
76,Iğdır,118,7,1,0,9,0,0,0,2023,125,1,9,0
77,Yalova,8525,422,12,0,9,0,0,0,2023,8947,12,9,0
78,Karabük,2213,148,1,1,5,0,0,0,2023,2361,2,5,0
79,Kilis,424,73,0,0,3,0,0,0,2023,497,0,3,0
80,Osmaniye,1931,230,0,0,10,1,0,0,2023,2161,0,11,0
81,Düzce,4115,1125,8,4,13,0,0,0,2023,5240,12,13,0
1,Adana,8829,1360,7,0,42,1,0,0,2022,10189,7,43,0
2,Adıyaman,792,141,0,0,3,0,0,0,2022,933,0,3,0
3,Afyonkarahisar,1755,362,1,0,4,0,0,0,2022,2117,1,4,0
4,Ağrı,303,139,0,0,5,0,0,0,2022,442,0,5,0
5,Amasya,1166,257,0,0,1,0,0,0,2022,1423,0,1,0
6,Ankara,30349,8110,21,4,94,5,0,0,2022,38459,25,99,0
7,Antalya,21926,10609,1,0,62,3,0,0,2022,32535,1,65,0
8,Artvin,510,62,4,0,2,0,0,0,2022,572,4,2,0
9,Aydın,5647,1546,0,0,14,1,0,0,2022,7193,0,15,0
10,Balıkesir,4450,1338,3,0,23,0,0,0,2022,5788,3,23,0
11,Bilecik,4070,1015,20,0,7,0,0,0,2022,5085,20,7,0
12,Bingöl,298,49,0,0,0,0,0,0,2022,347,0,0,0
13,Bitlis,212,63,0,0,3,0,0,0,2022,275,0,3,0
14,Bolu,2826,1622,3,0,10,0,0,0,2022,4448,3,10,0
15,Burdur,731,143,1,0,5,0,0,0,2022,874,1,5,0
16,Bursa,24756,7918,47,25,66,0,1,0,2022,32674,72,66,1
17,Çanakkale,2623,682,12,0,6,0,0,0,2022,3305,12,6,0
18,Çankırı,839,218,1,0,2,0,0,0,2022,1057,1,2,0
19,Çorum,1881,345,7,1,5,0,0,0,2022,2226,8,5,0
20,Denizli,7375,2137,0,1,24,2,0,0,2022,9512,1,26,0
21,Diyarbakır,2310,376,1,0,16,1,0,0,2022,2686,1,17,0
22,Edirne,1255,652,0,0,6,1,0,0,2022,1907,0,7,0
23,Elazığ,1060,178,0,0,8,1,0,0,2022,1238,0,9,0
24,Erzincan,457,121,0,0,2,0,0,0,2022,578,0,2,0
25,Erzurum,1694,248,2,0,10,0,0,0,2022,1942,2,10,0
26,Eskişehir,7164,2307,12,0,15,2,0,0,2022,9471,12,17,0
27,Gaziantep,10814,783,0,1,45,1,0,0,2022,11597,1,46,0
28,Giresun,1063,341,0,1,8,0,0,1,2022,1404,1,8,1
29,Gümüşhane,212,39,0,0,1,0,0,0,2022,251,0,1,0
30,Hakkari,154,7,0,0,6,0,0,0,2022,161,0,6,0
31,Hatay,3775,321,4,0,23,0,0,0,2022,4096,4,23,0
32,Isparta,1033,237,0,0,5,0,0,0,2022,1270,0,5,0
33,Mersin,9597,799,6,0,50,0,0,0,2022,10396,6,50,0
34,İstanbul,99994,30703,173,64,240,5,1,0,2022,130697,237,245,1
35,İzmir,37254,10191,33,10,89,4,3,0,2022,47445,43,93,3
36,Kars,124,30,1,0,2,0,0,0,2022,154,1,2,0
37,Kastamonu,1205,196,1,0,8,0,0,0,2022,1401,1,8,0
38,Kayseri,12946,1677,5,0,28,1,0,0,2022,14623,5,29,0
39,Kırklareli,2411,770,4,0,8,0,0,0,2022,3181,4,8,0
40,Kırşehir,1292,107,1,0,5,0,0,0,2022,1399,1,5,0
41,Kocaeli,31476,7828,133,35,57,1,0,0,2022,39304,168,58,0
42,Konya,10498,1929,11,1,39,2,0,0,2022,12427,12,41,0
43,Kütahya,4568,903,26,0,9,0,0,0,2022,5471,26,9,0
44,Malatya,2558,572,0,0,13,0,0,0,2022,3130,0,13,0
45,Manisa,15270,4768,19,2,28,3,0,0,2022,20038,21,31,0
46,Kahramanmaraş,3914,489,1,1,17,1,1,0,2022,4403,2,18,1
47,Mardin,563,83,0,0,21,1,0,0,2022,646,0,22,0
48,Muğla,6607,2697,0,1,23,0,0,0,2022,9304,1,23,0
49,Muş,147,76,0,0,2,0,0,0,2022,223,0,2,0
50,Nevşehir,784,172,1,0,6,0,0,0,2022,956,1,6,0
51,Niğde,861,134,0,0,7,0,0,0,2022,995,0,7,0
52,Ordu,1515,418,1,0,11,0,0,0,2022,1933,1,11,0
53,Rize,734,129,0,0,7,0,0,0,2022,863,0,7,0
54,Sakarya,8639,2885,15,7,12,1,0,0,2022,11524,22,13,0
55,Samsun,4686,865,2,0,16,0,0,0,2022,5551,2,16,0
56,Siirt,376,16,0,0,2,0,0,0,2022,392,0,2,0
57,Sinop,369,107,1,0,2,0,0,0,2022,476,1,2,0
58,Sivas,2089,417,0,2,25,0,0,0,2022,2506,2,25,0
59,Tekirdağ,15062,4464,14,13,22,1,0,0,2022,19526,27,23,0
60,Tokat,1094,314,1,0,4,0,0,0,2022,1408,1,4,0
61,Trabzon,1936,349,2,1,11,1,0,0,2022,2285,3,12,0
62,Tunceli,71,5,0,0,0,0,0,0,2022,76,0,0,0
63,Şanlıurfa,1441,144,0,0,17,0,0,0,2022,1585,0,17,0
64,Uşak,2749,943,2,0,6,0,0,0,2022,3692,2,6,0
65,Van,699,228,1,0,11,0,1,0,2022,927,1,11,1
66,Yozgat,871,180,0,0,5,0,0,0,2022,1051,0,5,0
67,Zonguldak,7424,364,38,0,14,0,0,0,2022,7788,38,14,0
68,Aksaray,1491,221,0,0,7,0,0,0,2022,1712,0,7,0
69,Bayburt,184,33,0,0,1,0,0,0,2022,217,0,1,0
70,Karaman,1814,1046,1,0,5,0,0,0,2022,2860,1,5,0
71,Kırıkkale,875,105,0,0,4,0,0,0,2022,980,0,4,0
72,Batman,748,150,1,0,10,0,0,0,2022,898,1,10,0
73,Şırnak,357,16,0,0,20,0,0,0,2022,373,0,20,0
74,Bartın,1364,189,0,0,48,0,0,0,2022,1553,0,48,0
75,Ardahan,46,7,0,0,0,0,0,0,2022,53,0,0,0
76,Iğdır,120,10,0,0,9,0,0,0,2022,130,0,9,0
77,Yalova,6749,286,31,0,8,0,0,0,2022,7035,31,8,0
78,Karabük,2089,124,1,0,7,0,0,0,2022,2213,1,7,0
79,Kilis,349,38,0,0,4,0,0,0,2022,387,0,4,0
80,Osmaniye,1822,186,1,0,6,0,0,0,2022,2008,1,6,0
81,Düzce,3608,965,14,3,9,0,0,0,2022,4573,17,9,0
1,Adana,7744,1051,6,1,37,0,0,0,2021,8795,7,37,0
2,Adıyaman,649,117,0,0,6,0,0,0,2021,766,0,6,0
3,Afyonkarahisar,1560,281,2,0,6,0,1,0,2021,1841,2,6,1
4,Ağrı,155,22,0,0,3,0,0,0,2021,177,0,3,0
5,Amasya,876,113,1,0,4,0,0,0,2021,989,1,4,0
6,Ankara,27642,5783,29,2,107,4,1,0,2021,33425,31,111,1
7,Antalya,15540,6801,3,0,44,5,0,0,2021,22341,3,49,0
8,Artvin,1483,39,3,2,11,0,0,0,2021,1522,5,11,0
9,Aydın,4588,1032,5,0,14,0,0,0,2021,5620,5,14,0
10,Balıkesir,3793,959,5,0,20,1,0,0,2021,4752,5,21,0
11,Bilecik,3767,921,11,0,5,0,0,0,2021,4688,11,5,0
12,Bingöl,236,11,0,0,5,0,0,0,2021,247,0,5,0
13,Bitlis,157,18,0,0,3,0,0,0,2021,175,0,3,0
14,Bolu,2767,1261,3,2,7,0,1,0,2021,4028,5,7,1
15,Burdur,635,130,0,0,4,1,0,0,2021,765,0,5,0
16,Bursa,20844,6316,32,15,66,1,0,0,2021,27160,47,67,0
17,Çanakkale,3025,461,4,0,12,0,0,0,2021,3486,4,12,0
18,Çankırı,703,126,3,0,1,0,0,0,2021,829,3,1,0
19,Çorum,1611,239,2,0,9,0,0,0,2021,1850,2,9,0
20,Denizli,6722,1902,1,0,13,0,0,0,2021,8624,1,13,0
21,Diyarbakır,1916,280,3,0,12,0,2,0,2021,2196,3,12,2
22,Edirne,957,379,1,0,8,0,0,0,2021,1336,1,8,0
23,Elazığ,1362,149,2,0,13,1,2,0,2021,1511,2,14,2
24,Erzincan,446,92,0,0,5,0,0,0,2021,538,0,5,0
25,Erzurum,1581,128,4,0,9,1,0,0,2021,1709,4,10,0
26,Eskişehir,6683,1900,8,0,27,0,0,0,2021,8583,8,27,0
27,Gaziantep,9760,428,1,0,39,0,1,0,2021,10188,1,39,1
28,Giresun,892,144,1,0,8,0,0,0,2021,1036,1,8,0
29,Gümüşhane,245,12,0,0,2,0,0,0,2021,257,0,2,0
30,Hakkari,160,10,0,0,0,0,0,0,2021,170,0,0,0
31,Hatay,3020,175,7,1,36,0,4,1,2021,3195,8,36,5
32,Isparta,901,186,1,0,7,1,0,0,2021,1087,1,8,0
33,Mersin,5890,570,6,0,42,0,3,0,2021,6460,6,42,3
34,İstanbul,92990,23580,241,111,218,4,6,1,2021,116570,352,222,7
35,İzmir,33388,8067,48,8,67,1,2,1,2021,41455,56,68,3
36,Kars,138,20,0,0,0,0,0,0,2021,158,0,0,0
37,Kastamonu,1077,148,1,0,9,1,1,0,2021,1225,1,10,1
38,Kayseri,12693,1422,6,0,24,0,0,0,2021,14115,6,24,0
39,Kırklareli,2209,717,2,0,11,0,0,0,2021,2926,2,11,0
40,Kırşehir,1023,56,0,0,3,0,0,0,2021,1079,0,3,0
41,Kocaeli,28208,6031,166,83,47,0,0,0,2021,34239,249,47,0
42,Konya,9251,1479,11,2,39,0,1,1,2021,10730,13,39,2
43,Kütahya,3823,629,8,0,15,1,0,0,2021,4452,8,16,0
44,Malatya,2073,336,0,0,8,0,0,0,2021,2409,0,8,0
45,Manisa,14083,3672,17,3,25,0,1,0,2021,17755,20,25,1
46,Kahramanmaraş,3647,458,1,0,18,0,0,0,2021,4105,1,18,0
47,Mardin,513,46,1,0,14,0,0,0,2021,559,1,14,0
48,Muğla,6072,2458,1,0,22,1,0,0,2021,8530,1,23,0
49,Muş,118,42,0,0,3,0,0,0,2021,160,0,3,0
50,Nevşehir,656,89,1,0,3,0,0,0,2021,745,1,3,0
51,Niğde,745,73,0,0,6,0,0,0,2021,818,0,6,0
52,Ordu,1452,293,1,0,2,0,0,0,2021,1745,1,2,0
53,Rize,760,71,0,0,10,0,0,0,2021,831,0,10,0
54,Sakarya,7611,2235,34,6,18,0,0,0,2021,9846,40,18,0
55,Samsun,4155,582,0,1,21,2,0,0,2021,4737,1,23,0
56,Siirt,293,6,0,0,1,0,0,0,2021,299,0,1,0
57,Sinop,273,58,0,0,2,0,0,0,2021,331,0,2,0
58,Sivas,1750,282,0,0,9,0,0,0,2021,2032,0,9,0
59,Tekirdağ,14823,4208,23,8,27,5,0,0,2021,19031,31,32,0
60,Tokat,961,236,3,0,13,0,0,0,2021,1197,3,13,0
61,Trabzon,1968,294,1,0,7,0,1,0,2021,2262,1,7,1
62,Tunceli,56,9,0,0,2,0,0,0,2021,65,0,2,0
63,Şanlıurfa,1025,74,1,0,7,0,0,0,2021,1099,1,7,0
64,Uşak,2869,881,2,0,6,0,0,0,2021,3750,2,6,0
65,Van,543,126,1,0,9,1,1,0,2021,669,1,10,1
66,Yozgat,959,168,0,0,5,0,0,0,2021,1127,0,5,0
67,Zonguldak,6447,338,28,0,16,0,0,0,2021,6785,28,16,0
68,Aksaray,1447,132,2,0,8,0,0,0,2021,1579,2,8,0
69,Bayburt,156,28,0,0,2,0,0,0,2021,184,0,2,0
70,Karaman,1907,917,0,0,1,0,0,0,2021,2824,0,1,0
71,Kırıkkale,797,71,0,0,2,0,0,0,2021,868,0,2,0
72,Batman,610,104,1,0,10,0,0,0,2021,714,1,10,0
73,Şırnak,307,5,0,0,16,0,0,0,2021,312,0,16,0
74,Bartın,1214,151,1,0,3,0,1,0,2021,1365,1,3,1
75,Ardahan,37,15,0,0,1,0,0,0,2021,52,0,1,0
76,Iğdır,84,2,0,0,4,0,0,0,2021,86,0,4,0
77,Yalova,5975,217,22,1,6,0,0,0,2021,6192,23,6,0
78,Karabük,2278,137,3,0,6,0,0,0,2021,2415,3,6,0
79,Kilis,232,12,0,0,1,0,0,0,2021,244,0,1,0
80,Osmaniye,1915,248,1,0,11,1,1,0,2021,2163,1,12,1
81,Düzce,3157,747,11,9,7,0,1,0,2021,3904,20,7,1
1,Adana,6144,762,7,1,36,0,0,0,2020,6906,8,36,0
2,Adıyaman,478,74,0,0,6,0,0,0,2020,552,0,6,0
3,Afyonkarahisar,1171,161,1,0,16,0,0,0,2020,1332,1,16,0
4,Ağrı,102,16,0,0,2,0,0,0,2020,118,0,2,0
5,Amasya,766,80,0,0,3,1,0,0,2020,846,0,4,0
6,Ankara,21175,4446,29,2,101,2,0,0,2020,25621,31,103,0
7,Antalya,10658,4080,1,1,35,1,0,0,2020,14738,2,36,0
8,Artvin,1126,29,3,3,3,0,0,0,2020,1155,6,3,0
9,Aydın,3417,673,1,0,10,1,0,0,2020,4090,1,11,0
10,Balıkesir,3112,852,2,1,17,0,0,0,2020,3964,3,17,0
11,Bilecik,2899,619,21,1,3,0,0,0,2020,3518,22,3,0
12,Bingöl,220,29,0,0,2,0,0,0,2020,249,0,2,0
13,Bitlis,139,14,0,0,4,0,0,0,2020,153,0,4,0
14,Bolu,2004,838,1,2,7,0,0,0,2020,2842,3,7,0
15,Burdur,451,77,0,0,1,0,0,0,2020,528,0,1,0
16,Bursa,15757,4612,41,26,47,2,0,0,2020,20369,67,49,0
17,Çanakkale,2050,338,3,0,12,1,0,0,2020,2388,3,13,0
18,Çankırı,541,60,1,0,3,0,1,0,2020,601,1,3,1
19,Çorum,1188,169,4,0,6,0,0,0,2020,1357,4,6,0
20,Denizli,4947,1365,0,1,21,0,0,0,2020,6312,1,21,0
21,Diyarbakır,1441,171,0,0,15,0,0,0,2020,1612,0,15,0
22,Edirne,737,376,0,2,5,1,0,0,2020,1113,2,6,0
23,Elazığ,1085,121,0,0,15,0,0,0,2020,1206,0,15,0
24,Erzincan,390,36,0,0,3,0,0,0,2020,426,0,3,0
25,Erzurum,1000,80,2,0,10,0,0,0,2020,1080,2,10,0
26,Eskişehir,5166,1563,9,0,12,2,0,0,2020,6729,9,14,0
27,Gaziantep,6780,284,2,0,27,0,0,0,2020,7064,2,27,0
28,Giresun,786,159,0,0,7,0,0,0,2020,945,0,7,0
29,Gümüşhane,254,30,1,0,3,0,0,0,2020,284,1,3,0
30,Hakkari,126,3,0,0,4,0,0,0,2020,129,0,4,0
31,Hatay,2170,129,2,0,21,1,0,0,2020,2299,2,22,0
32,Isparta,684,122,0,0,7,0,0,0,2020,806,0,7,0
33,Mersin,3644,410,1,0,42,1,0,0,2020,4054,1,43,0
34,İstanbul,74457,19008,173,83,185,3,1,0,2020,93465,256,188,1
35,İzmir,25014,5932,34,9,91,4,0,0,2020,30946,43,95,0
36,Kars,135,17,1,0,1,0,0,0,2020,152,1,1,0
37,Kastamonu,860,133,2,0,3,0,1,0,2020,993,2,3,1
38,Kayseri,9353,1004,0,0,15,1,0,0,2020,10357,0,16,0
39,Kırklareli,1607,448,2,0,4,1,0,0,2020,2055,2,5,0
40,Kırşehir,788,57,2,0,5,0,0,0,2020,845,2,5,0
41,Kocaeli,21587,4341,73,19,44,0,0,0,2020,25928,92,44,0
42,Konya,7344,1154,10,0,23,1,0,0,2020,8498,10,24,0
43,Kütahya,2853,435,15,0,5,0,1,0,2020,3288,15,5,1
44,Malatya,1703,272,0,0,8,1,0,0,2020,1975,0,9,0
45,Manisa,10236,2577,18,0,23,4,1,0,2020,12813,18,27,1
46,Kahramanmaraş,2403,195,4,4,16,0,0,0,2020,2598,8,16,0
47,Mardin,441,40,0,0,14,0,0,0,2020,481,0,14,0
48,Muğla,4277,1608,2,0,20,0,0,0,2020,5885,2,20,0
49,Muş,191,37,0,0,2,0,0,0,2020,228,0,2,0
50,Nevşehir,577,81,0,0,9,0,0,0,2020,658,0,9,0
51,Niğde,549,70,0,0,3,0,0,0,2020,619,0,3,0
52,Ordu,998,284,3,0,13,1,0,0,2020,1282,3,14,0
53,Rize,682,105,0,0,6,1,0,0,2020,787,0,7,0
54,Sakarya,5868,1743,33,3,17,1,0,0,2020,7611,36,18,0
55,Samsun,2968,485,2,0,15,0,0,0,2020,3453,2,15,0
56,Siirt,275,3,0,0,2,0,0,0,2020,278,0,2,0
57,Sinop,188,25,1,0,1,0,0,0,2020,213,1,1,0
58,Sivas,1281,248,3,3,8,0,0,0,2020,1529,6,8,0
59,Tekirdağ,9555,2441,15,3,13,3,0,0,2020,11996,18,16,0
60,Tokat,719,183,2,1,3,0,0,0,2020,902,3,3,0
61,Trabzon,1377,212,0,0,17,0,0,0,2020,1589,0,17,0
62,Tunceli,69,1,0,0,1,0,0,0,2020,70,0,1,0
63,Şanlıurfa,797,33,0,0,13,0,0,0,2020,830,0,13,0
64,Uşak,1960,574,3,0,11,0,0,0,2020,2534,3,11,0
65,Van,491,97,0,0,7,0,0,0,2020,588,0,7,0
66,Yozgat,619,148,3,2,8,0,0,0,2020,767,5,8,0
67,Zonguldak,5230,267,32,0,12,0,0,0,2020,5497,32,12,0
68,Aksaray,1163,72,1,0,9,0,0,0,2020,1235,1,9,0
69,Bayburt,46,2,0,0,0,0,0,0,2020,48,0,0,0
70,Karaman,1705,972,0,1,7,0,0,0,2020,2677,1,7,0
71,Kırıkkale,554,61,0,0,5,0,0,0,2020,615,0,5,0
72,Batman,564,72,0,0,8,0,0,0,2020,636,0,8,0
73,Şırnak,275,7,0,0,22,0,0,0,2020,282,0,22,0
74,Bartın,852,81,0,0,2,0,0,0,2020,933,0,2,0
75,Ardahan,25,1,0,0,1,0,0,0,2020,26,0,1,0
76,Iğdır,87,2,0,0,1,0,0,0,2020,89,0,1,0
77,Yalova,4187,159,13,0,5,0,0,0,2020,4346,13,5,0
78,Karabük,1640,70,0,0,2,0,0,0,2020,1710,0,2,0
79,Kilis,164,24,0,0,1,0,0,0,2020,188,0,1,0
80,Osmaniye,1215,173,0,0,2,0,0,0,2020,1388,0,2,0
81,Düzce,2360,633,9,1,8,0,0,0,2020,2993,10,8,0
1,Adana,5685,865,3,0,30,1,0,0,2019,6550,3,31,0
2,Adıyaman,450,99,0,0,4,0,0,0,2019,549,0,4,0
3,Afyonkarahisar,1153,163,1,0,12,0,0,0,2019,1316,1,12,0
4,Ağrı,106,8,0,0,3,0,0,0,2019,114,0,3,0
5,Amasya,670,102,2,0,1,0,0,0,2019,772,2,1,0
6,Ankara,24286,6000,54,0,87,1,0,0,2019,30286,54,88,0
7,Antalya,16103,7380,0,2,47,0,0,0,2019,23483,2,47,0
8,Artvin,1154,34,1,0,6,1,0,0,2019,1188,1,7,0
9,Aydın,3566,934,3,1,18,0,0,0,2019,4500,4,18,0
10,Balıkesir,3104,1031,5,0,21,0,0,0,2019,4135,5,21,0
11,Bilecik,3173,668,51,0,4,0,0,0,2019,3841,51,4,0
12,Bingöl,430,37,0,0,5,0,0,0,2019,467,0,5,0
13,Bitlis,119,19,0,0,5,0,0,0,2019,138,0,5,0
14,Bolu,1965,876,0,0,11,0,0,0,2019,2841,0,11,0
15,Burdur,580,99,0,0,3,0,0,0,2019,679,0,3,0
16,Bursa,17736,5339,24,5,45,3,0,0,2019,23075,29,48,0
17,Çanakkale,1906,301,10,1,7,0,0,0,2019,2207,11,7,0
18,Çankırı,383,55,2,0,2,0,0,0,2019,438,2,2,0
19,Çorum,1111,154,0,0,6,0,0,0,2019,1265,0,6,0
20,Denizli,5101,1671,1,1,20,0,0,0,2019,6772,2,20,0
21,Diyarbakır,1615,265,0,0,20,0,0,0,2019,1880,0,20,0
22,Edirne,764,470,1,0,2,0,0,0,2019,1234,1,2,0
23,Elazığ,768,144,2,0,11,0,0,0,2019,912,2,11,0
24,Erzincan,310,31,0,0,1,1,0,0,2019,341,0,2,0
25,Erzurum,1093,97,2,0,9,0,0,0,2019,1190,2,9,0
26,Eskişehir,5533,1750,15,0,14,0,0,0,2019,7283,15,14,0
27,Gaziantep,5692,356,2,0,28,0,0,0,2019,6048,2,28,0
28,Giresun,827,174,0,0,6,0,0,0,2019,1001,0,6,0
29,Gümüşhane,200,22,0,0,3,0,0,0,2019,222,0,3,0
30,Hakkari,212,7,1,0,7,0,0,0,2019,219,1,7,0
31,Hatay,2133,124,5,0,16,0,0,0,2019,2257,5,16,0
32,Isparta,901,217,0,0,8,0,0,0,2019,1118,0,8,0
33,Mersin,3459,614,0,0,31,0,0,0,2019,4073,0,31,0
34,İstanbul,85298,24397,153,33,198,1,0,0,2019,109695,186,199,0
35,İzmir,27076,7542,104,11,51,4,0,0,2019,34618,115,55,0
36,Kars,165,15,0,0,2,0,0,0,2019,180,0,2,0
37,Kastamonu,744,136,0,0,6,0,0,0,2019,880,0,6,0
38,Kayseri,9077,1197,9,0,24,1,0,0,2019,10274,9,25,0
39,Kırklareli,1734,513,9,0,5,0,0,0,2019,2247,9,5,0
40,Kırşehir,930,99,0,0,5,0,0,0,2019,1029,0,5,0
41,Kocaeli,21884,4060,117,16,40,1,0,0,2019,25944,133,41,0
42,Konya,6324,1089,6,0,35,1,0,0,2019,7413,6,36,0
43,Kütahya,2872,466,69,1,6,0,0,0,2019,3338,70,6,0
44,Malatya,1590,240,0,0,11,0,0,0,2019,1830,0,11,0
45,Manisa,11226,2902,24,1,13,0,0,0,2019,14128,25,13,0
46,Kahramanmaraş,2203,223,1,0,6,1,0,0,2019,2426,1,7,0
47,Mardin,394,33,0,0,19,0,0,0,2019,427,0,19,0
48,Muğla,5252,2070,6,0,23,0,0,0,2019,7322,6,23,0
49,Muş,276,54,0,0,3,0,0,0,2019,330,0,3,0
50,Nevşehir,538,94,3,0,4,0,0,0,2019,632,3,4,0
51,Niğde,592,76,0,0,9,1,0,0,2019,668,0,10,0
52,Ordu,1077,324,0,0,7,0,0,0,2019,1401,0,7,0
53,Rize,711,76,2,0,6,0,0,0,2019,787,2,6,0
54,Sakarya,5762,1793,26,4,6,0,0,0,2019,7555,30,6,0
55,Samsun,2501,581,0,0,4,1,0,0,2019,3082,0,5,0
56,Siirt,458,1,0,0,3,0,0,0,2019,459,0,3,0
57,Sinop,172,61,1,0,2,0,0,0,2019,233,1,2,0
58,Sivas,1330,276,2,0,12,0,0,0,2019,1606,2,12,0
59,Tekirdağ,9546,2642,13,6,13,1,0,0,2019,12188,19,14,0
60,Tokat,756,169,0,1,3,0,0,0,2019,925,1,3,0
61,Trabzon,1365,275,1,0,15,0,0,0,2019,1640,1,15,0
62,Tunceli,55,4,0,0,0,0,0,0,2019,59,0,0,0
63,Şanlıurfa,669,65,0,0,10,0,0,0,2019,734,0,10,0
64,Uşak,1677,527,1,1,9,1,0,0,2019,2204,2,10,0
65,Van,441,88,0,0,6,0,0,0,2019,529,0,6,0
66,Yozgat,824,174,0,0,10,0,0,0,2019,998,0,10,0
67,Zonguldak,5357,313,48,0,10,0,0,0,2019,5670,48,10,0
68,Aksaray,1031,87,0,0,5,0,0,0,2019,1118,0,5,0
69,Bayburt,70,3,0,0,3,0,0,0,2019,73,0,3,0
70,Karaman,1607,1050,0,0,8,0,0,0,2019,2657,0,8,0
71,Kırıkkale,595,97,1,0,2,0,0,0,2019,692,1,2,0
72,Batman,514,70,0,0,9,1,0,0,2019,584,0,10,0
73,Şırnak,282,6,0,0,8,0,0,0,2019,288,0,8,0
74,Bartın,824,128,6,0,3,0,0,0,2019,952,6,3,0
75,Ardahan,82,6,0,0,1,0,0,0,2019,88,0,1,0
76,Iğdır,75,2,0,0,5,0,0,0,2019,77,0,5,0
77,Yalova,3959,206,24,0,3,0,0,0,2019,4165,24,3,0
78,Karabük,1743,242,1,0,2,0,0,0,2019,1985,1,2,0
79,Kilis,85,10,0,0,1,0,0,0,2019,95,0,1,0
80,Osmaniye,1117,160,0,0,3,0,0,0,2019,1277,0,3,0
81,Düzce,1960,607,8,3,4,0,0,0,2019,2567,11,4,0
1,Adana,5521,844,3,0,47,0,0,0,2018,6365,3,47,0
2,Adıyaman,494,132,0,0,13,0,0,0,2018,626,0,13,0
3,Afyonkarahisar,1044,172,1,0,16,1,0,0,2018,1216,1,17,0
4,Ağrı,159,7,0,0,3,0,0,0,2018,166,0,3,0
5,Amasya,801,82,0,0,2,0,0,0,2018,883,0,2,0
6,Ankara,25734,4491,57,3,118,5,0,0,2018,30225,60,123,0
7,Antalya,12699,5231,0,1,49,4,0,0,2018,17930,1,53,0
8,Artvin,621,36,0,0,7,0,0,0,2018,657,0,7,0
9,Aydın,3760,821,2,1,17,0,0,0,2018,4581,3,17,0
10,Balıkesir,3195,899,3,1,26,6,0,0,2018,4094,4,32,0
11,Bilecik,2899,758,27,0,7,0,0,0,2018,3657,27,7,0
12,Bingöl,314,39,0,0,5,0,0,0,2018,353,0,5,0
13,Bitlis,113,7,0,0,2,0,0,0,2018,120,0,2,0
14,Bolu,1802,732,8,0,9,0,0,0,2018,2534,8,9,0
15,Burdur,722,100,1,0,4,0,0,0,2018,822,1,4,0
16,Bursa,19116,5173,18,7,58,3,0,0,2018,24289,25,61,0
17,Çanakkale,1872,269,5,1,9,0,0,0,2018,2141,6,9,0
18,Çankırı,427,69,2,0,2,0,0,0,2018,496,2,2,0
19,Çorum,1294,159,9,0,6,0,0,0,2018,1453,9,6,0
20,Denizli,5534,1611,0,0,21,0,0,0,2018,7145,0,21,0
21,Diyarbakır,1602,328,0,0,17,0,0,0,2018,1930,0,17,0
22,Edirne,717,406,1,0,6,0,0,0,2018,1123,1,6,0
23,Elazığ,979,126,1,0,15,0,0,0,2018,1105,1,15,0
24,Erzincan,345,22,0,0,6,0,0,0,2018,367,0,6,0
25,Erzurum,1197,105,1,0,14,0,0,0,2018,1302,1,14,0
26,Eskişehir,5839,1546,25,2,12,1,0,0,2018,7385,27,13,0
27,Gaziantep,5181,298,4,0,28,0,0,0,2018,5479,4,28,0
28,Giresun,840,162,0,0,9,0,0,0,2018,1002,0,9,0
29,Gümüşhane,225,20,2,0,2,0,0,0,2018,245,2,2,0
30,Hakkari,167,1,0,0,10,0,0,0,2018,168,0,10,0
31,Hatay,2274,118,3,0,26,1,0,0,2018,2392,3,27,0
32,Isparta,935,202,0,0,12,0,0,0,2018,1137,0,12,0
33,Mersin,3262,456,3,0,37,3,0,0,2018,3718,3,40,0
34,İstanbul,94584,22330,117,29,286,14,0,0,2018,116914,146,300,0
35,İzmir,32977,7187,22,4,77,5,0,0,2018,40164,26,82,0
36,Kars,193,14,0,0,2,0,0,0,2018,207,0,2,0
37,Kastamonu,864,117,1,0,9,0,0,0,2018,981,1,9,0
38,Kayseri,8642,1126,3,1,23,0,0,0,2018,9768,4,23,0
39,Kırklareli,1563,415,4,0,8,0,0,0,2018,1978,4,8,0
40,Kırşehir,1102,82,0,0,2,0,0,0,2018,1184,0,2,0
41,Kocaeli,22562,3905,77,12,64,0,0,0,2018,26467,89,64,0
42,Konya,6642,1002,7,1,44,0,0,0,2018,7644,8,44,0
43,Kütahya,3508,444,69,1,9,0,0,0,2018,3952,70,9,0
44,Malatya,1756,150,0,0,13,0,0,0,2018,1906,0,13,0
45,Manisa,12729,2842,45,1,26,0,0,0,2018,15571,46,26,0
46,Kahramanmaraş,1917,161,0,0,17,1,0,0,2018,2078,0,18,0
47,Mardin,497,15,0,0,14,0,0,0,2018,512,0,14,0
48,Muğla,5136,1880,0,0,28,0,0,0,2018,7016,0,28,0
49,Muş,188,68,0,0,3,0,0,0,2018,256,0,3,0
50,Nevşehir,614,68,0,0,7,0,0,0,2018,682,0,7,0
51,Niğde,596,80,0,0,6,0,0,0,2018,676,0,6,0
52,Ordu,1103,274,0,0,4,0,0,0,2018,1377,0,4,0
53,Rize,749,65,0,0,5,0,0,0,2018,814,0,5,0
54,Sakarya,5922,1536,16,3,10,1,0,0,2018,7458,19,11,0
55,Samsun,2667,553,0,0,19,0,0,0,2018,3220,0,19,0
56,Siirt,297,4,0,0,1,0,0,0,2018,301,0,1,0
57,Sinop,175,28,0,0,2,0,0,0,2018,203,0,2,0
58,Sivas,1497,235,0,0,14,0,0,0,2018,1732,0,14,0
59,Tekirdağ,9771,2734,9,0,27,0,0,0,2018,12505,9,27,0
60,Tokat,851,128,1,0,9,0,0,0,2018,979,1,9,0
61,Trabzon,1394,300,0,0,25,0,0,0,2018,1694,0,25,0
62,Tunceli,73,6,0,0,0,0,0,0,2018,79,0,0,0
63,Şanlıurfa,626,24,0,0,11,0,0,0,2018,650,0,11,0
64,Uşak,1793,439,6,1,9,0,0,0,2018,2232,7,9,0
65,Van,517,60,0,0,7,0,0,0,2018,577,0,7,0
66,Yozgat,870,138,0,0,2,0,0,0,2018,1008,0,2,0
67,Zonguldak,4363,280,87,0,14,0,0,0,2018,4643,87,14,0
68,Aksaray,1277,128,0,0,7,0,0,0,2018,1405,0,7,0
69,Bayburt,98,3,0,0,1,0,0,0,2018,101,0,1,0
70,Karaman,1965,1334,0,0,7,0,0,0,2018,3299,0,7,0
71,Kırıkkale,696,59,2,0,6,0,0,0,2018,755,2,6,0
72,Batman,408,29,0,0,10,0,0,0,2018,437,0,10,0
73,Şırnak,401,1,0,0,7,0,0,0,2018,402,0,7,0
74,Bartın,1003,86,11,0,5,0,0,0,2018,1089,11,5,0
75,Ardahan,279,3,0,0,3,0,0,0,2018,282,0,3,0
76,Iğdır,46,2,1,0,3,0,0,0,2018,48,1,3,0
77,Yalova,2538,173,11,1,6,0,0,0,2018,2711,12,6,0
78,Karabük,1741,119,2,0,14,0,0,0,2018,1860,2,14,0
79,Kilis,83,6,0,0,0,0,0,0,2018,89,0,0,0
80,Osmaniye,1382,88,0,0,8,0,0,0,2018,1470,0,8,0
81,Düzce,1969,534,7,2,6,1,0,0,2018,2503,9,7,0
1,Adana,4805,616,3,2,54,1,0,0,2017,5421,5,55,0
2,Adıyaman,394,110,0,0,6,0,0,0,2017,504,0,6,0
3,Afyonkarahisar,1003,124,1,0,12,0,0,0,2017,1127,1,12,0
4,Ağrı,87,2,0,0,2,0,0,0,2017,89,0,2,0
5,Amasya,748,83,0,0,7,0,0,0,2017,831,0,7,0
6,Ankara,21709,3261,51,1,116,0,0,0,2017,24970,52,116,0
7,Antalya,8478,3087,4,1,54,4,0,0,2017,11565,5,58,0
8,Artvin,545,23,0,0,6,0,0,0,2017,568,0,6,0
9,Aydın,3140,686,0,1,14,0,0,0,2017,3826,1,14,0
10,Balıkesir,2993,935,5,0,28,0,0,0,2017,3928,5,28,0
11,Bilecik,2626,701,9,1,2,0,0,0,2017,3327,10,2,0
12,Bingöl,351,31,0,0,2,0,0,0,2017,382,0,2,0
13,Bitlis,77,2,0,0,2,1,0,0,2017,79,0,3,0
14,Bolu,1431,547,2,0,12,0,0,0,2017,1978,2,12,0
15,Burdur,647,88,0,0,9,0,0,0,2017,735,0,9,0
16,Bursa,17518,4225,6,0,71,2,0,0,2017,21743,6,73,0
17,Çanakkale,1948,221,5,0,14,0,0,0,2017,2169,5,14,0
18,Çankırı,433,68,1,0,3,0,0,0,2017,501,1,3,0
19,Çorum,1085,132,3,0,5,1,0,0,2017,1217,3,6,0
20,Denizli,5335,1423,0,1,21,0,0,0,2017,6758,1,21,0
21,Diyarbakır,1281,136,1,0,10,0,0,0,2017,1417,1,10,0
22,Edirne,636,329,0,0,5,0,0,0,2017,965,0,5,0
23,Elazığ,871,91,1,0,18,0,0,0,2017,962,1,18,0
24,Erzincan,320,36,3,0,1,0,0,0,2017,356,3,1,0
25,Erzurum,1157,70,3,0,11,0,0,0,2017,1227,3,11,0
26,Eskişehir,5178,1367,2,0,14,0,0,0,2017,6545,2,14,0
27,Gaziantep,4034,184,2,0,31,0,0,0,2017,4218,2,31,0
28,Giresun,655,127,1,0,5,0,0,0,2017,782,1,5,0
29,Gümüşhane,171,9,0,0,4,0,0,0,2017,180,0,4,0
30,Hakkari,79,0,0,0,13,0,0,0,2017,79,0,13,0
31,Hatay,1971,64,3,0,27,0,0,0,2017,2035,3,27,0
32,Isparta,734,133,0,0,12,0,0,0,2017,867,0,12,0
33,Mersin,2784,284,4,0,48,0,0,0,2017,3068,4,48,0
34,İstanbul,76877,16126,113,11,325,5,0,0,2017,93003,124,330,0
35,İzmir,25706,5318,31,7,93,2,0,0,2017,31024,38,95,0
36,Kars,321,21,0,0,9,0,0,0,2017,342,0,9,0
37,Kastamonu,650,55,0,0,10,0,0,0,2017,705,0,10,0
38,Kayseri,8138,861,2,0,34,0,0,0,2017,8999,2,34,0
39,Kırklareli,1673,380,14,0,5,0,0,0,2017,2053,14,5,0
40,Kırşehir,869,33,1,0,10,0,0,0,2017,902,1,10,0
41,Kocaeli,20030,3035,63,6,46,0,0,0,2017,23065,69,46,0
42,Konya,6006,880,2,0,39,1,0,0,2017,6886,2,40,0
43,Kütahya,3075,365,46,1,12,2,0,0,2017,3440,47,14,0
44,Malatya,1276,98,0,0,15,0,0,0,2017,1374,0,15,0
45,Manisa,10709,2205,8,0,30,1,0,0,2017,12914,8,31,0
46,Kahramanmaraş,1706,137,0,0,19,1,0,0,2017,1843,0,20,0
47,Mardin,534,8,0,0,9,0,0,0,2017,542,0,9,0
48,Muğla,3800,1397,0,0,21,3,0,0,2017,5197,0,24,0
49,Muş,111,54,0,0,2,0,0,0,2017,165,0,2,0
50,Nevşehir,520,65,0,0,5,0,0,0,2017,585,0,5,0
51,Niğde,760,64,0,0,12,1,0,0,2017,824,0,13,0
52,Ordu,963,231,0,0,10,0,0,0,2017,1194,0,10,0
53,Rize,692,37,3,0,8,0,0,0,2017,729,3,8,0
54,Sakarya,5656,1342,13,1,12,0,0,0,2017,6998,14,12,0
55,Samsun,2514,549,2,0,16,0,0,0,2017,3063,2,16,0
56,Siirt,116,8,0,0,5,0,0,0,2017,124,0,5,0
57,Sinop,238,33,0,0,5,0,0,0,2017,271,0,5,0
58,Sivas,1232,139,0,0,12,0,0,0,2017,1371,0,12,0
59,Tekirdağ,8991,2237,7,1,32,1,0,0,2017,11228,8,33,0
60,Tokat,793,126,5,0,5,0,0,0,2017,919,5,5,0
61,Trabzon,1259,235,1,0,8,2,0,0,2017,1494,1,10,0
62,Tunceli,65,3,0,0,1,0,0,0,2017,68,0,1,0
63,Şanlıurfa,585,34,1,0,17,0,0,0,2017,619,1,17,0
64,Uşak,1539,428,2,0,7,1,0,0,2017,1967,2,8,0
65,Van,363,54,2,0,14,0,0,0,2017,417,2,14,0
66,Yozgat,782,155,0,0,9,0,0,0,2017,937,0,9,0
67,Zonguldak,4450,193,40,0,23,0,0,0,2017,4643,40,23,0
68,Aksaray,1064,81,4,0,6,0,0,0,2017,1145,4,6,0
69,Bayburt,61,6,0,0,1,0,0,0,2017,67,0,1,0
70,Karaman,2184,1749,0,0,4,0,0,0,2017,3933,0,4,0
71,Kırıkkale,690,49,1,0,6,0,0,0,2017,739,1,6,0
72,Batman,265,18,0,0,4,0,0,0,2017,283,0,4,0
73,Şırnak,299,1,0,0,24,0,0,0,2017,300,0,24,0
74,Bartın,883,74,3,0,7,0,0,0,2017,957,3,7,0
75,Ardahan,180,2,0,0,2,0,0,0,2017,182,0,2,0
76,Iğdır,47,5,0,0,6,0,0,0,2017,52,0,6,0
77,Yalova,2096,124,6,0,7,0,0,0,2017,2220,6,7,0
78,Karabük,1744,151,0,0,6,0,0,0,2017,1895,0,6,0
79,Kilis,68,14,0,0,0,0,0,0,2017,82,0,0,0
80,Osmaniye,1132,58,0,0,9,0,0,0,2017,1190,0,9,0
81,Düzce,1833,448,2,2,3,0,0,0,2017,2281,4,3,0
1,Adana,3806,399,0,0,43,3,0,0,2016,4205,0,46,0
2,Adıyaman,298,75,0,0,4,0,0,0,2016,373,0,4,0
3,Afyonkarahisar,660,95,0,0,10,0,0,0,2016,755,0,10,0
4,Ağrı,85,1,0,0,5,0,0,0,2016,86,0,5,0
5,Amasya,464,61,0,0,3,0,0,0,2016,525,0,3,0
6,Ankara,18415,2626,30,0,100,2,0,0,2016,21041,30,102,0
7,Antalya,7081,2412,0,0,46,2,0,0,2016,9493,0,48,0
8,Artvin,235,14,0,0,6,0,0,0,2016,249,0,6,0
9,Aydın,2371,435,0,0,13,0,0,0,2016,2806,0,13,0
10,Balıkesir,2388,724,2,0,12,0,0,0,2016,3112,2,12,0
11,Bilecik,1967,527,8,0,5,0,0,0,2016,2494,8,5,0
12,Bingöl,244,30,3,0,3,0,0,0,2016,274,3,3,0
13,Bitlis,64,5,0,0,4,0,0,0,2016,69,0,4,0
14,Bolu,1269,475,2,2,6,0,0,0,2016,1744,4,6,0
15,Burdur,555,100,0,0,11,0,0,0,2016,655,0,11,0
16,Bursa,15972,3643,5,0,63,3,0,0,2016,19615,5,66,0
17,Çanakkale,1282,196,5,0,11,0,0,0,2016,1478,5,11,0
18,Çankırı,462,394,0,0,7,0,0,0,2016,856,0,7,0
19,Çorum,820,82,16,0,7,0,0,0,2016,902,16,7,0
20,Denizli,4598,1101,1,0,20,0,0,0,2016,5699,1,20,0
21,Diyarbakır,830,109,0,0,13,0,0,0,2016,939,0,13,0
22,Edirne,489,227,0,0,5,0,0,0,2016,716,0,5,0
23,Elazığ,531,57,0,0,9,0,0,0,2016,588,0,9,0
24,Erzincan,162,15,0,0,0,0,0,0,2016,177,0,0,0
25,Erzurum,666,35,0,0,14,0,0,0,2016,701,0,14,0
26,Eskişehir,4489,1547,0,0,17,2,0,0,2016,6036,0,19,0
27,Gaziantep,2932,124,0,0,22,0,0,0,2016,3056,0,22,0
28,Giresun,375,72,0,0,6,0,0,0,2016,447,0,6,0
29,Gümüşhane,124,4,1,0,1,0,0,0,2016,128,1,1,0
30,Hakkari,28,1,0,0,7,0,0,0,2016,29,0,7,0
31,Hatay,1699,27,4,0,19,0,0,0,2016,1726,4,19,0
32,Isparta,720,96,0,0,10,0,0,0,2016,816,0,10,0
33,Mersin,2927,191,0,0,46,1,0,0,2016,3118,0,47,0
34,İstanbul,57463,12174,104,8,306,11,0,0,2016,69637,112,317,0
35,İzmir,20742,4032,28,6,65,1,0,0,2016,24774,34,66,0
36,Kars,176,3,0,0,7,0,0,0,2016,179,0,7,0
37,Kastamonu,457,42,0,0,7,0,0,0,2016,499,0,7,0
38,Kayseri,7035,662,0,0,26,0,0,0,2016,7697,0,26,0
39,Kırklareli,1983,296,4,0,2,1,0,0,2016,2279,4,3,0
40,Kırşehir,834,16,1,0,5,0,0,0,2016,850,1,5,0
41,Kocaeli,16728,2457,26,3,38,1,0,0,2016,19185,29,39,0
42,Konya,4811,523,4,0,40,0,0,0,2016,5334,4,40,0
43,Kütahya,2323,253,11,0,7,1,0,0,2016,2576,11,8,0
44,Malatya,786,55,0,0,9,0,0,0,2016,841,0,9,0
45,Manisa,9132,1737,14,2,24,1,0,0,2016,10869,16,25,0
46,Kahramanmaraş,1282,113,0,0,9,0,0,0,2016,1395,0,9,0
47,Mardin,290,10,0,0,16,0,0,0,2016,300,0,16,0
48,Muğla,2670,889,2,0,16,1,0,0,2016,3559,2,17,0
49,Muş,43,6,0,0,1,0,0,0,2016,49,0,1,0
50,Nevşehir,427,34,0,1,2,0,0,0,2016,461,1,2,0
51,Niğde,517,46,0,0,9,1,0,0,2016,563,0,10,0
52,Ordu,719,162,0,0,12,0,0,0,2016,881,0,12,0
53,Rize,609,21,1,0,8,0,0,0,2016,630,1,8,0
54,Sakarya,4828,832,5,0,17,1,0,0,2016,5660,5,18,0
55,Samsun,1848,381,1,0,16,0,0,0,2016,2229,1,16,0
56,Siirt,184,2,1,1,18,0,0,0,2016,186,2,18,0
57,Sinop,167,22,1,0,5,0,0,0,2016,189,1,5,0
58,Sivas,1056,75,0,0,12,0,0,0,2016,1131,0,12,0
59,Tekirdağ,6951,1627,19,0,24,0,0,0,2016,8578,19,24,0
60,Tokat,468,98,1,0,7,0,0,0,2016,566,1,7,0
61,Trabzon,910,184,0,0,8,0,0,0,2016,1094,0,8,0
62,Tunceli,48,3,0,0,3,0,0,0,2016,51,0,3,0
63,Şanlıurfa,389,17,0,0,9,0,0,0,2016,406,0,9,0
64,Uşak,1245,299,0,1,5,1,0,0,2016,1544,1,6,0
65,Van,201,71,0,0,5,0,0,0,2016,272,0,5,0
66,Yozgat,748,74,0,0,4,0,0,0,2016,822,0,4,0
67,Zonguldak,4287,137,87,0,13,0,0,0,2016,4424,87,13,0
68,Aksaray,804,76,0,0,7,0,0,0,2016,880,0,7,0
69,Bayburt,23,5,0,0,1,0,0,0,2016,28,0,1,0
70,Karaman,1399,942,0,0,7,1,0,0,2016,2341,0,8,0
71,Kırıkkale,587,27,0,0,4,0,0,0,2016,614,0,4,0
72,Batman,197,13,1,0,5,0,0,0,2016,210,1,5,0
73,Şırnak,115,2,0,0,10,1,0,0,2016,117,0,11,0
74,Bartın,737,43,4,0,4,0,0,0,2016,780,4,4,0
75,Ardahan,36,0,0,0,1,0,0,0,2016,36,0,1,0
76,Iğdır,46,1,0,0,4,0,0,0,2016,47,0,4,0
77,Yalova,1599,102,1,0,6,0,0,0,2016,1701,1,6,0
78,Karabük,1569,92,0,1,7,0,0,0,2016,1661,1,7,0
79,Kilis,48,4,0,0,3,1,0,0,2016,52,0,4,0
80,Osmaniye,840,35,0,0,3,0,0,0,2016,875,0,3,0
81,Düzce,1750,358,4,0,4,0,0,0,2016,2108,4,4,0
1,Adana,2350,266,0,0,32,0,0,0,2015,2616,0,32,0
2,Adıyaman,214,78,0,0,4,0,0,0,2015,292,0,4,0
3,Afyonkarahisar,647,42,0,0,17,0,0,0,2015,689,0,17,0
4,Ağrı,59,0,0,0,4,0,0,0,2015,59,0,4,0
5,Amasya,320,15,0,0,3,0,0,0,2015,335,0,3,0
6,Ankara,15858,1835,44,2,97,7,0,0,2015,17693,46,104,0
7,Antalya,6228,1872,2,1,38,1,0,0,2015,8100,3,39,0
8,Artvin,279,4,0,0,3,0,0,0,2015,283,0,3,0
9,Aydın,1983,436,0,0,15,0,0,0,2015,2419,0,15,0
10,Balıkesir,2111,464,1,0,19,0,0,0,2015,2575,1,19,0
11,Bilecik,1881,440,2,0,5,0,0,0,2015,2321,2,5,0
12,Bingöl,160,3,0,0,5,0,0,0,2015,163,0,5,0
13,Bitlis,64,0,0,0,5,0,0,0,2015,64,0,5,0
14,Bolu,1046,344,0,0,13,2,0,0,2015,1390,0,15,0
15,Burdur,403,43,0,0,10,0,0,0,2015,446,0,10,0
16,Bursa,14719,3082,1,0,57,4,0,0,2015,17801,1,61,0
17,Çanakkale,1050,125,4,0,7,0,0,0,2015,1175,4,7,0
18,Çankırı,321,36,1,0,4,0,0,0,2015,357,1,4,0
19,Çorum,640,40,4,0,7,0,0,0,2015,680,4,7,0
20,Denizli,4114,1067,0,0,20,0,0,0,2015,5181,0,20,0
21,Diyarbakır,684,82,0,0,17,0,0,0,2015,766,0,17,0
22,Edirne,545,211,0,0,6,0,0,0,2015,756,0,6,0
23,Elazığ,529,61,0,0,7,0,0,0,2015,590,0,7,0
24,Erzincan,136,12,0,0,2,0,0,0,2015,148,0,2,0
25,Erzurum,607,29,0,0,8,0,0,0,2015,636,0,8,0
26,Eskişehir,4382,919,2,0,11,1,0,0,2015,5301,2,12,0
27,Gaziantep,2878,98,0,0,22,0,0,0,2015,2976,0,22,0
28,Giresun,300,34,1,0,4,0,0,0,2015,334,1,4,0
29,Gümüşhane,111,0,0,0,3,0,0,0,2015,111,0,3,0
30,Hakkari,28,0,0,0,2,0,0,0,2015,28,0,2,0
31,Hatay,1764,29,4,0,18,1,0,0,2015,1793,4,19,0
32,Isparta,569,93,0,0,10,0,0,0,2015,662,0,10,0
33,Mersin,2367,144,0,0,27,0,0,0,2015,2511,0,27,0
34,İstanbul,46869,9754,91,14,239,2,0,0,2015,56623,105,241,0
35,İzmir,19028,3544,12,0,68,1,0,0,2015,22572,12,69,0
36,Kars,78,0,0,0,3,0,0,0,2015,78,0,3,0
37,Kastamonu,419,24,0,0,3,1,0,0,2015,443,0,4,0
38,Kayseri,6511,531,2,0,19,1,0,0,2015,7042,2,20,0
39,Kırklareli,1259,276,0,0,5,1,0,0,2015,1535,0,6,0
40,Kırşehir,699,18,0,0,4,0,0,0,2015,717,0,4,0
41,Kocaeli,15484,1942,46,10,40,1,0,0,2015,17426,56,41,0
42,Konya,4257,413,2,1,51,0,0,0,2015,4670,3,51,0
43,Kütahya,1976,225,8,0,12,2,0,0,2015,2201,8,14,0
44,Malatya,713,51,0,0,12,1,0,0,2015,764,0,13,0
45,Manisa,7909,1376,1,3,12,1,0,0,2015,9285,4,13,0
46,Kahramanmaraş,1131,83,0,0,17,0,0,0,2015,1214,0,17,0
47,Mardin,177,4,0,0,15,0,0,0,2015,181,0,15,0
48,Muğla,1958,587,1,0,9,1,0,0,2015,2545,1,10,0
49,Muş,58,3,0,0,2,0,0,0,2015,61,0,2,0
50,Nevşehir,236,32,0,0,2,0,0,0,2015,268,0,2,0
51,Niğde,408,28,0,0,4,0,0,0,2015,436,0,4,0
52,Ordu,503,83,0,0,7,0,0,0,2015,586,0,7,0
53,Rize,413,16,1,0,3,0,0,0,2015,429,1,3,0
54,Sakarya,3779,500,4,0,6,0,0,0,2015,4279,4,6,0
55,Samsun,1361,154,1,0,14,1,0,0,2015,1515,1,15,0
56,Siirt,198,2,0,0,4,0,0,0,2015,200,0,4,0
57,Sinop,134,12,0,0,9,0,0,0,2015,146,0,9,0
58,Sivas,852,28,0,0,12,0,0,0,2015,880,0,12,0
59,Tekirdağ,5766,1417,4,1,18,0,0,0,2015,7183,5,18,0
60,Tokat,369,43,0,0,5,0,0,0,2015,412,0,5,0
61,Trabzon,230,48,1,0,8,0,0,0,2015,278,1,8,0
62,Tunceli,23,1,0,0,1,0,0,0,2015,24,0,1,0
63,Şanlıurfa,449,12,1,0,11,0,0,0,2015,461,1,11,0
64,Uşak,1111,192,2,0,5,0,0,0,2015,1303,2,5,0
65,Van,169,5,0,0,8,0,0,0,2015,174,0,8,0
66,Yozgat,466,17,1,0,1,0,0,0,2015,483,1,1,0
67,Zonguldak,4176,145,90,0,17,0,0,0,2015,4321,90,17,0
68,Aksaray,750,68,0,0,9,1,0,0,2015,818,0,10,0
69,Bayburt,34,4,0,0,0,0,0,0,2015,38,0,0,0
70,Karaman,936,549,0,0,3,3,0,0,2015,1485,0,6,0
71,Kırıkkale,797,33,0,0,7,0,0,0,2015,830,0,7,0
72,Batman,163,7,0,0,4,0,0,0,2015,170,0,4,0
73,Şırnak,112,2,0,0,17,0,0,0,2015,114,0,17,0
74,Bartın,663,48,4,0,3,0,0,0,2015,711,4,3,0
75,Ardahan,31,0,0,0,1,0,0,0,2015,31,0,1,0
76,Iğdır,32,2,0,0,3,0,0,0,2015,34,0,3,0
77,Yalova,1141,88,1,0,3,0,0,0,2015,1229,1,3,0
78,Karabük,1623,74,0,1,3,0,0,0,2015,1697,1,3,0
79,Kilis,34,0,0,0,1,0,0,0,2015,34,0,1,0
80,Osmaniye,652,16,0,0,6,0,0,0,2015,668,0,6,0
81,Düzce,1438,264,1,1,11,0,0,0,2015,1702,2,11,0
1,Adana,2749,219,0,0,35,1,0,0,2014,2968,0,36,0
2,Adıyaman,227,52,0,0,4,0,0,0,2014,279,0,4,0
3,Afyonkarahisar,662,35,0,0,15,0,0,0,2014,697,0,15,0
4,Ağrı,80,0,0,0,7,0,0,0,2014,80,0,7,0
5,Amasya,368,10,0,0,2,2,0,0,2014,378,0,4,0
6,Ankara,14099,1496,9,0,105,2,0,0,2014,15595,9,107,0
7,Antalya,6308,1947,2,0,42,5,0,0,2014,8255,2,47,0
8,Artvin,391,6,0,0,7,0,0,0,2014,397,0,7,0
9,Aydın,1930,345,3,2,18,0,0,0,2014,2275,5,18,0
10,Balıkesir,2054,338,3,0,16,1,0,0,2014,2392,3,17,0
11,Bilecik,2010,404,30,1,5,0,0,0,2014,2414,31,5,0
12,Bingöl,131,5,0,0,0,0,0,0,2014,136,0,0,0
13,Bitlis,71,0,0,0,3,0,0,0,2014,71,0,3,0
14,Bolu,1149,256,2,0,8,0,0,0,2014,1405,2,8,0
15,Burdur,386,22,0,0,5,0,0,0,2014,408,0,5,0
16,Bursa,13477,2656,1,0,46,1,0,0,2014,16133,1,47,0
17,Çanakkale,846,106,5,0,7,1,0,0,2014,952,5,8,0
18,Çankırı,309,22,0,0,5,0,0,0,2014,331,0,5,0
19,Çorum,541,17,0,0,8,0,0,0,2014,558,0,8,0
20,Denizli,4137,846,0,0,16,1,0,0,2014,4983,0,17,0
21,Diyarbakır,739,50,0,0,14,0,0,0,2014,789,0,14,0
22,Edirne,596,228,0,0,0,1,0,0,2014,824,0,1,0
23,Elazığ,516,24,0,0,13,0,0,0,2014,540,0,13,0
24,Erzincan,205,11,0,0,2,0,0,0,2014,216,0,2,0
25,Erzurum,589,33,0,0,10,0,0,0,2014,622,0,10,0
26,Eskişehir,4292,671,0,0,13,0,0,0,2014,4963,0,13,0
27,Gaziantep,2452,103,0,0,32,1,0,0,2014,2555,0,33,0
28,Giresun,274,21,0,0,3,0,0,0,2014,295,0,3,0
29,Gümüşhane,99,1,0,0,1,0,0,0,2014,100,0,1,0
30,Hakkari,31,0,0,0,2,0,0,0,2014,31,0,2,0
31,Hatay,1613,26,0,0,22,0,0,0,2014,1639,0,22,0
32,Isparta,513,43,0,0,19,0,0,0,2014,556,0,19,0
33,Mersin,1780,109,0,0,33,1,0,0,2014,1889,0,34,0
34,İstanbul,39415,7144,108,9,237,6,0,0,2014,46559,117,243,0
35,İzmir,18003,2811,9,1,63,1,0,0,2014,20814,10,64,0
36,Kars,99,3,0,0,7,0,0,0,2014,102,0,7,0
37,Kastamonu,294,30,0,0,6,1,0,0,2014,324,0,7,0
38,Kayseri,6819,485,1,0,30,1,0,0,2014,7304,1,31,0
39,Kırklareli,1147,262,2,0,11,1,0,0,2014,1409,2,12,0
40,Kırşehir,770,4,0,0,3,0,0,0,2014,774,0,3,0
41,Kocaeli,13783,1517,25,8,43,2,0,0,2014,15300,33,45,0
42,Konya,3900,231,0,0,36,0,0,0,2014,4131,0,36,0
43,Kütahya,2165,196,6,0,10,1,0,0,2014,2361,6,11,0
44,Malatya,679,42,1,0,11,0,0,0,2014,721,1,11,0
45,Manisa,9634,1649,0,2,325,2,0,0,2014,11283,2,327,0
46,Kahramanmaraş,1115,85,0,0,20,0,0,0,2014,1200,0,20,0
47,Mardin,174,3,3,1,12,0,0,0,2014,177,4,12,0
48,Muğla,2008,418,0,0,25,1,0,0,2014,2426,0,26,0
49,Muş,87,0,0,0,5,0,0,0,2014,87,0,5,0
50,Nevşehir,253,12,0,0,4,0,0,0,2014,265,0,4,0
51,Niğde,334,23,1,0,4,0,0,0,2014,357,1,4,0
52,Ordu,576,94,0,0,8,0,0,0,2014,670,0,8,0
53,Rize,381,13,0,0,4,0,0,0,2014,394,0,4,0
54,Sakarya,3244,367,4,0,15,0,0,0,2014,3611,4,15,0
55,Samsun,1183,104,0,0,10,0,0,0,2014,1287,0,10,0
56,Siirt,284,1,0,0,1,0,0,0,2014,285,0,1,0
57,Sinop,138,13,0,0,1,0,0,0,2014,151,0,1,0
58,Sivas,869,34,0,0,5,0,0,0,2014,903,0,5,0
59,Tekirdağ,5361,1235,0,0,19,1,0,0,2014,6596,0,20,0
60,Tokat,337,20,0,0,12,0,0,0,2014,357,0,12,0
61,Trabzon,459,35,1,0,12,0,0,0,2014,494,1,12,0
62,Tunceli,28,0,0,0,1,0,0,0,2014,28,0,1,0
63,Şanlıurfa,431,8,0,0,11,0,0,0,2014,439,0,11,0
64,Uşak,1095,199,0,0,4,0,0,0,2014,1294,0,4,0
65,Van,157,4,0,0,5,0,0,0,2014,161,0,5,0
66,Yozgat,472,15,0,0,2,0,0,0,2014,487,0,2,0
67,Zonguldak,4083,80,21,0,12,0,0,0,2014,4163,21,12,0
68,Aksaray,631,58,0,0,7,0,0,0,2014,689,0,7,0
69,Bayburt,19,0,0,0,0,0,0,0,2014,19,0,0,0
70,Karaman,1054,422,0,0,28,2,0,0,2014,1476,0,30,0
71,Kırıkkale,401,19,2,0,3,0,0,0,2014,420,2,3,0
72,Batman,205,7,0,0,9,0,0,0,2014,212,0,9,0
73,Şırnak,101,0,0,0,15,0,0,0,2014,101,0,15,0
74,Bartın,614,30,1,0,5,1,0,0,2014,644,1,6,0
75,Ardahan,29,0,0,0,2,0,0,0,2014,29,0,2,0
76,Iğdır,64,0,0,0,5,0,0,0,2014,64,0,5,0
77,Yalova,866,63,0,0,7,0,0,0,2014,929,0,7,0
78,Karabük,1487,45,0,0,9,0,0,0,2014,1532,0,9,0
79,Kilis,30,1,0,0,0,0,0,0,2014,31,0,0,0
80,Osmaniye,731,25,0,0,4,0,0,0,2014,756,0,4,0
81,Düzce,1559,265,0,0,3,0,0,0,2014,1824,0,3,0
1,Adana,2757,202,1,0,29,0,0,0,2013,2959,1,29,0
2,Adıyaman,226,45,0,0,7,0,0,0,2013,271,0,7,0
3,Afyonkarahisar,569,58,0,0,7,0,0,0,2013,627,0,7,0
4,Ağrı,53,1,0,0,0,0,0,0,2013,54,0,0,0
5,Amasya,430,10,0,0,4,1,0,0,2013,440,0,5,0
6,Ankara,11467,1063,6,0,115,1,0,0,2013,12530,6,116,0
7,Antalya,5357,1432,0,0,61,1,0,0,2013,6789,0,62,0
8,Artvin,304,3,0,0,9,0,0,0,2013,307,0,9,0
9,Aydın,1991,303,1,0,18,0,0,0,2013,2294,1,18,0
10,Balıkesir,1833,353,1,0,12,0,0,0,2013,2186,1,12,0
11,Bilecik,2020,239,6,0,11,0,0,0,2013,2259,6,11,0
12,Bingöl,116,1,0,0,2,0,0,0,2013,117,0,2,0
13,Bitlis,37,1,0,0,1,0,0,0,2013,38,0,1,0
14,Bolu,952,232,0,0,7,1,0,0,2013,1184,0,8,0
15,Burdur,328,9,0,0,4,0,0,0,2013,337,0,4,0
16,Bursa,12291,2077,7,0,43,1,0,0,2013,14368,7,44,0
17,Çanakkale,771,72,1,0,9,0,0,0,2013,843,1,9,0
18,Çankırı,227,18,3,0,4,0,0,0,2013,245,3,4,0
19,Çorum,462,13,0,0,3,0,0,0,2013,475,0,3,0
20,Denizli,4094,699,0,0,13,0,0,0,2013,4793,0,13,0
21,Diyarbakır,429,28,0,0,16,2,0,0,2013,457,0,18,0
22,Edirne,522,236,0,0,4,0,0,0,2013,758,0,4,0
23,Elazığ,526,19,0,0,13,0,0,0,2013,545,0,13,0
24,Erzincan,152,3,0,0,5,0,0,0,2013,155,0,5,0
25,Erzurum,562,25,0,0,13,0,0,0,2013,587,0,13,0
26,Eskişehir,4358,532,0,0,19,0,0,0,2013,4890,0,19,0
27,Gaziantep,2160,82,0,0,37,0,0,0,2013,2242,0,37,0
28,Giresun,248,16,0,0,6,0,0,0,2013,264,0,6,0
29,Gümüşhane,130,4,0,0,3,0,0,0,2013,134,0,3,0
30,Hakkari,20,0,0,0,0,0,0,0,2013,20,0,0,0
31,Hatay,1634,13,0,0,28,0,0,0,2013,1647,0,28,0
32,Isparta,371,40,0,0,4,1,0,0,2013,411,0,5,0
33,Mersin,1632,97,0,0,33,1,0,0,2013,1729,0,34,0
34,İstanbul,32130,4946,32,7,213,5,0,0,2013,37076,39,218,0
35,İzmir,17124,2305,3,0,81,1,0,0,2013,19429,3,82,0
36,Kars,97,0,0,0,5,0,0,0,2013,97,0,5,0
37,Kastamonu,260,23,1,0,6,1,0,0,2013,283,1,7,0
38,Kayseri,6328,307,0,0,37,0,0,0,2013,6635,0,37,0
39,Kırklareli,968,166,0,0,11,0,0,0,2013,1134,0,11,0
40,Kırşehir,564,8,0,0,4,0,0,0,2013,572,0,4,0
41,Kocaeli,11474,1002,10,0,32,1,0,0,2013,12476,10,33,0
42,Konya,3657,183,0,0,39,1,0,0,2013,3840,0,40,0
43,Kütahya,1761,161,2,0,12,0,0,0,2013,1922,2,12,0
44,Malatya,488,25,0,0,10,0,0,0,2013,513,0,10,0
45,Manisa,9734,972,1,0,27,1,0,0,2013,10706,1,28,0
46,Kahramanmaraş,999,48,0,0,15,0,0,0,2013,1047,0,15,0
47,Mardin,115,0,0,0,8,0,0,0,2013,115,0,8,0
48,Muğla,1708,243,2,0,21,1,0,0,2013,1951,2,22,0
49,Muş,62,1,0,0,2,0,0,0,2013,63,0,2,0
50,Nevşehir,201,21,0,0,15,0,0,0,2013,222,0,15,0
51,Niğde,293,16,0,0,5,0,0,0,2013,309,0,5,0
52,Ordu,600,71,0,0,7,0,0,0,2013,671,0,7,0
53,Rize,247,8,0,0,2,0,0,0,2013,255,0,2,0
54,Sakarya,2447,272,0,0,17,0,0,0,2013,2719,0,17,0
55,Samsun,1108,106,0,0,19,0,0,0,2013,1214,0,19,0
56,Siirt,231,3,0,0,4,0,0,0,2013,234,0,4,0
57,Sinop,150,8,0,0,5,0,0,0,2013,158,0,5,0
58,Sivas,697,13,0,0,13,0,0,0,2013,710,0,13,0
59,Tekirdağ,4411,990,0,0,24,2,0,0,2013,5401,0,26,0
60,Tokat,294,10,0,0,11,0,0,0,2013,304,0,11,0
61,Trabzon,548,19,0,0,10,0,0,0,2013,567,0,10,0
62,Tunceli,29,1,0,0,0,0,0,0,2013,30,0,0,0
63,Şanlıurfa,377,30,2,0,22,0,0,0,2013,407,2,22,0
64,Uşak,974,154,0,1,6,1,0,0,2013,1128,1,7,0
65,Van,167,3,0,0,14,0,0,0,2013,170,0,14,0
66,Yozgat,368,4,0,0,5,0,0,0,2013,372,0,5,0
67,Zonguldak,4105,72,43,0,19,1,0,0,2013,4177,43,20,0
68,Aksaray,420,23,0,0,6,0,0,0,2013,443,0,6,0
69,Bayburt,16,0,0,0,0,0,0,0,2013,16,0,0,0
70,Karaman,889,306,0,0,7,0,0,0,2013,1195,0,7,0
71,Kırıkkale,406,10,4,0,6,0,0,0,2013,416,4,6,0
72,Batman,149,5,0,0,6,0,0,0,2013,154,0,6,0
73,Şırnak,84,1,0,0,10,0,0,0,2013,85,0,10,0
74,Bartın,674,25,0,0,3,0,0,0,2013,699,0,3,0
75,Ardahan,25,0,0,0,2,0,0,0,2013,25,0,2,0
76,Iğdır,34,0,0,0,5,0,0,0,2013,34,0,5,0
77,Yalova,575,41,0,0,2,0,0,0,2013,616,0,2,0
78,Karabük,1426,16,1,0,12,0,0,0,2013,1442,1,12,0
79,Kilis,38,0,0,0,2,0,0,0,2013,38,0,2,0
80,Osmaniye,673,11,1,0,10,0,0,0,2013,684,1,10,0
81,Düzce,1490,190,0,0,4,0,0,0,2013,1680,0,4,0
1, Adana,1035,33,0,0,19,0,0,0,2012,1068,0,19,0
2, Adıyaman,162,35,0,0,2,0,0,0,2012,197,0,2,0
3, Afyonkarahisar,443,11,0,0,2,0,0,0,2012,454,0,2,0
4, Ağrı,5,0,0,0,2,0,0,0,2012,5,0,2,0
5, Amasya,195,1,0,0,8,0,0,0,2012,196,0,8,0
6, Ankara,2969,112,61,2,52,0,0,0,2012,3081,63,52,0
7, Antalya,1295,273,0,0,15,1,0,0,2012,1568,0,16,0
8, Artvin,323,5,0,1,5,0,0,0,2012,328,1,5,0
9, Aydın,799,75,0,0,1,0,0,0,2012,874,0,1,0
10, Balıkesir,782,165,5,0,4,0,0,0,2012,947,5,4,0
11, Bilecik,526,77,1,0,4,0,0,0,2012,603,1,4,0
12, Bingöl,38,0,0,0,4,0,0,0,2012,38,0,4,0
13, Bitlis,31,0,0,0,1,0,0,0,2012,31,0,1,0
14, Bolu,449,67,1,0,2,0,0,0,2012,516,1,2,0
15, Burdur,110,2,0,0,4,0,0,0,2012,112,0,4,0
16, Bursa,8117,1186,1,0,30,0,0,0,2012,9303,1,30,0
17, Çanakkale,264,21,0,0,0,0,0,0,2012,285,0,0,0
18, Çankırı,98,5,2,0,3,0,0,0,2012,103,2,3,0
19, Çorum,0,0,0,0,5,0,0,0,2012,0,0,5,0
20, Denizli,2276,344,0,1,10,0,0,0,2012,2620,1,10,0
21, Diyarbakır,150,4,0,0,8,0,0,0,2012,154,0,8,0
22, Edirne,159,66,1,1,0,0,0,0,2012,225,2,0,0
23, Elazığ,505,5,0,0,12,0,0,0,2012,510,0,12,0
24, Erzincan,66,2,0,0,5,0,0,0,2012,68,0,5,0
25, Erzurum,386,15,4,2,16,0,0,0,2012,401,6,16,0
26, Eskişehir,806,75,0,0,9,1,0,0,2012,881,0,10,0
27, Gaziantep,948,16,0,0,25,0,0,0,2012,964,0,25,0
28, Gıresun,88,2,1,0,4,0,0,0,2012,90,1,4,0
29, Gümüşhane,46,1,0,0,2,0,0,0,2012,47,0,2,0
30, Hakkari,0,0,0,0,3,0,0,0,2012,0,0,3,0
31, Hatay,603,2,0,0,18,0,0,0,2012,605,0,18,0
32, Isparta,146,18,0,0,4,0,0,0,2012,164,0,4,0
33, Mersin,496,14,2,0,13,0,0,0,2012,510,2,13,0
34, İstanbul,8570,880,20,1,145,2,0,0,2012,9450,21,147,0
35, İzmir,7074,522,19,1,41,1,0,0,2012,7596,20,42,0
36, Kars,17,0,0,0,1,0,0,0,2012,17,0,1,0
37, Kastamonu,65,5,0,0,5,0,0,0,2012,70,0,5,0
38, Kayseri,2478,79,0,0,12,0,0,0,2012,2557,0,12,0
39, Kırklareli,284,53,0,0,0,0,0,0,2012,337,0,0,0
40, Kırşehır,228,2,0,0,3,0,0,0,2012,230,0,3,0
41, Kocaeli,2896,156,11,0,20,0,0,0,2012,3052,11,20,0
42, Konya,958,25,0,0,23,0,1,0,2012,983,0,23,1
43, Kütahya,1251,50,7,0,6,0,0,0,2012,1301,7,6,0
44, Malatya,139,2,0,0,6,0,0,0,2012,141,0,6,0
45, Manisa,6801,426,8,0,12,1,0,0,2012,7227,8,13,0
46, Kahramanmaraş,473,36,6,0,17,0,0,0,2012,509,6,17,0
47, Mardin,11,0,0,0,3,0,0,0,2012,11,0,3,0
48, Muğla,731,74,1,0,10,0,0,0,2012,805,1,10,0
49, Muş,7,0,0,0,2,0,0,0,2012,7,0,2,0
50, Nevşehir,55,3,0,0,1,0,0,0,2012,58,0,1,0
51, Niğde,75,3,2,0,4,1,0,0,2012,78,2,5,0
52, Ordu,244,15,0,0,6,0,0,0,2012,259,0,6,0
53, Rize,116,4,1,0,1,0,0,0,2012,120,1,1,0
54, Sakarya,380,29,0,0,9,1,0,0,2012,409,0,10,0
55, Samsun,527,12,0,0,10,1,0,0,2012,539,0,11,0
56, Siirt,3,0,0,0,4,0,0,0,2012,3,0,4,0
57, Sinop,109,5,0,0,4,0,0,0,2012,114,0,4,0
58, Sivas,219,7,3,0,7,0,0,0,2012,226,3,7,0
59, Tekirdağ,2658,475,0,0,12,0,0,0,2012,3133,0,12,0
60, Tokat,142,6,0,0,2,0,0,0,2012,148,0,2,0
61, Trabzon,350,14,1,0,3,0,0,0,2012,364,1,3,0
62, Tunceli,14,1,0,0,0,0,0,0,2012,15,0,0,0
63, Şanlıurfa,102,1,0,0,7,0,0,0,2012,103,0,7,0
64, Uşak,596,50,1,0,5,0,0,0,2012,646,1,5,0
65, Van,67,0,0,0,9,0,0,0,2012,67,0,9,0
66, Yozgat,69,0,0,0,2,0,0,0,2012,69,0,2,0
67, Zonguldak,3884,34,221,0,14,0,0,0,2012,3918,221,14,0
68, Aksaray,124,4,0,0,2,0,0,0,2012,128,0,2,0
69, Bayburt,40,1,0,0,1,0,0,0,2012,41,0,1,0
70, Karaman,321,75,0,0,0,0,0,0,2012,396,0,0,0
71, Kırıkkale,144,6,0,0,4,0,0,0,2012,150,0,4,0
72, Batman,69,1,1,0,8,0,0,0,2012,70,1,8,0
73, Şırnak,2,0,0,0,2,0,0,0,2012,2,0,2,0
74, Bartın,266,5,4,0,3,0,0,0,2012,271,4,3,0
75, Ardahan,1,0,0,0,0,0,0,0,2012,1,0,0,0
76, Iğdır,0,0,0,0,1,0,0,0,2012,0,0,1,0
77, Yalova,311,10,0,0,1,0,0,0,2012,321,0,1,0
78, Karabük,918,11,1,0,3,0,0,0,2012,929,1,3,0
79, Kilis,49,1,0,0,0,0,0,0,2012,50,0,0,0
80, Osmaniye,269,9,0,0,8,0,0,0,2012,278,0,8,0
81, Düzce,667,57,0,0,4,0,0,0,2012,724,0,4,0
1, ADANA,554,28,0,0,49,0,0,0,2011,582,0,49,0
2, ADIYAMAN,91,26,0,0,5,0,0,0,2011,117,0,5,0
3,AFYONKARAHİSAR,202,5,0,0,13,0,0,0,2011,207,0,13,0
4, AĞRI,15,0,0,0,3,0,0,0,2011,15,0,3,0
5, AMASYA,143,2,0,0,11,0,0,0,2011,145,0,11,0
6, ANKARA,2524,101,148,6,168,4,3,0,2011,2625,154,172,3
7, ANTALYA,1372,268,0,0,57,3,0,0,2011,1640,0,60,0
8, ARTVİN,267,5,0,0,7,0,0,0,2011,272,0,7,0
9, AYDIN,837,52,1,0,23,0,0,0,2011,889,1,23,0
10, BALIKESİR,993,182,1,0,42,0,0,0,2011,1175,1,42,0
11, BİLECİK,1120,86,4,0,6,0,0,0,2011,1206,4,6,0
12, BİNGÖL,15,0,0,0,8,0,0,0,2011,15,0,8,0
13, BİTLİS,58,0,0,0,5,0,0,0,2011,58,0,5,0
14, BOLU,514,61,0,0,10,0,0,0,2011,575,0,10,0
15, BURDUR,163,6,0,0,12,0,0,0,2011,169,0,12,0
16, BURSA,4943,507,4,0,47,3,1,0,2011,5450,4,50,1
17, ÇANAKKALE,237,21,0,0,14,0,0,0,2011,258,0,14,0
18, ÇANKIRI,118,5,0,0,3,0,0,0,2011,123,0,3,0
19, ÇORUM,203,2,0,0,9,0,0,0,2011,205,0,9,0
20, DENİZLİ,2182,235,1,0,26,2,0,0,2011,2417,1,28,0
21, DİYARBAKIR,127,1,0,0,17,0,0,0,2011,128,0,17,0
22, EDİRNE,194,44,0,0,9,0,0,0,2011,238,0,9,0
23, ELAZIĞ,236,3,0,0,19,0,0,0,2011,239,0,19,0
24, ERZİNCAN,43,0,0,0,3,0,0,0,2011,43,0,3,0
25, ERZURUM,223,4,0,0,12,0,0,0,2011,227,0,12,0
26, ESKİŞEHİR,2417,144,7,0,15,0,0,0,2011,2561,7,15,0
27, GAZİANTEP,571,36,0,0,31,1,0,0,2011,607,0,32,0
28, GİRESUN,108,4,0,0,9,0,0,0,2011,112,0,9,0
29, GÜMÜŞHANE,20,0,0,0,1,0,0,0,2011,20,0,1,0
30, HAKKARİ,2,0,0,0,3,0,0,0,2011,2,0,3,0
31, HATAY,613,0,0,0,34,0,0,0,2011,613,0,34,0
32, ISPARTA,113,7,1,0,7,0,0,0,2011,120,1,7,0
33, MERSİN,512,8,0,0,38,0,0,0,2011,520,0,38,0
34, İSTANBUL,8558,745,44,3,297,5,0,0,2011,9303,47,302,0
35, İZMİR,7362,490,14,0,126,1,0,0,2011,7852,14,127,0
36, KARS,12,0,0,0,0,0,0,0,2011,12,0,0,0
37, KASTAMONU,52,2,1,0,9,0,0,0,2011,54,1,9,0
38, KAYSERİ,2484,50,0,0,22,0,0,0,2011,2534,0,22,0
39, KIRKLARELİ,603,110,3,0,5,0,0,0,2011,713,3,5,0
40, KIRŞEHİR,144,1,0,0,6,0,0,0,2011,145,0,6,0
41, KOCAELİ,4520,218,1,1,47,0,0,0,2011,4738,2,47,0
42, KONYA,621,15,4,0,34,1,0,0,2011,636,4,35,0
43, KÜTAHYA,1404,32,278,0,14,0,0,0,2011,1436,278,14,0
44, MALATYA,164,2,1,0,8,0,0,0,2011,166,1,8,0
45, MANİSA,5447,182,2,0,24,0,0,0,2011,5629,2,24,0
46, KAHRAMANMARAŞ,126,2,1,0,36,0,0,0,2011,128,1,36,0
47, MARDİN,0,0,0,0,14,0,0,0,2011,0,0,14,0
48, MUĞLA,630,62,1,0,18,0,0,0,2011,692,1,18,0
49, MUŞ,6,0,0,0,2,0,0,0,2011,6,0,2,0
50, NEVŞEHİR,71,6,0,0,6,0,0,0,2011,77,0,6,0
51, NİĞDE,109,1,0,0,6,0,0,0,2011,110,0,6,0
52, ORDU,291,12,0,0,13,0,0,0,2011,303,0,13,0
53, RİZE,94,4,0,0,6,0,0,0,2011,98,0,6,0
54, SAKARYA,548,23,8,0,11,1,0,0,2011,571,8,12,0
55, SAMSUN,961,34,0,0,10,1,0,0,2011,995,0,11,0
56, SİİRT,12,0,0,0,10,0,0,0,2011,12,0,10,0
57, SİNOP,88,1,0,0,3,0,0,0,2011,89,0,3,0
58, SİVAS,288,4,0,0,22,0,2,0,2011,292,0,22,2
59, TEKİRDAĞ,894,148,0,0,20,2,0,0,2011,1042,0,22,0
60, TOKAT,113,2,1,0,11,0,0,0,2011,115,1,11,0
61, TRABZON,336,9,0,0,9,0,0,0,2011,345,0,9,0
62, TUNCELİ,27,0,0,0,1,0,0,0,2011,27,0,1,0
63,ŞANLIURFA,70,0,0,0,23,5,0,0,2011,70,0,28,0
64, UŞAK,467,40,0,0,8,0,0,0,2011,507,0,8,0
65, VAN,28,0,0,0,7,0,0,0,2011,28,0,7,0
66, YOZGAT,0,0,0,0,5,0,0,0,2011,0,0,5,0
67, ZONGULDAK,3921,22,159,0,29,0,4,0,2011,3943,159,29,4
68, AKSARAY,81,4,0,0,5,0,0,0,2011,85,0,5,0
69, BAYBURT,44,0,0,0,1,0,0,0,2011,44,0,1,0
70, KARAMAN,267,43,0,0,6,0,0,0,2011,310,0,6,0
71, KIRIKKALE,113,1,1,0,5,0,0,0,2011,114,1,5,0
72, BATMAN,103,0,0,0,26,0,0,0,2011,103,0,26,0
73, ŞIRNAK,0,0,0,0,15,0,0,0,2011,0,0,15,0
74, BARTIN,492,8,0,0,5,0,0,0,2011,500,0,5,0
75, ARDAHAN,0,0,0,0,0,0,0,0,2011,0,0,0,0
76, IĞDIR,14,0,0,0,3,0,0,0,2011,14,0,3,0
77, YALOVA,198,7,0,0,4,3,0,0,2011,205,0,7,0
78, KARABÜK,1143,9,1,0,6,0,0,0,2011,1152,1,6,0
79, KİLİS,29,1,0,0,0,0,0,0,2011,30,0,0,0
80, OSMANİYE,0,0,0,0,7,0,0,0,2011,0,0,7,0
81, DÜZCE,394,35,0,0,7,0,0,0,2011,429,0,7,0
1, ADANA,680,21,0,0,29,1,0,0,2009,701,0,30,0
2, ADIYAMAN,67,29,0,0,2,0,0,0,2009,96,0,2,0
3,AFYON,149,1,0,0,16,0,0,0,2009,150,0,16,0
4, AĞRI,7,1,0,0,2,0,0,0,2009,8,0,2,0
5, AMASYA,260,1,0,0,4,0,0,0,2009,261,0,4,0
6, ANKARA,2620,95,185,7,124,1,2,0,2009,2715,192,125,2
7, ANTALYA,1323,257,0,0,37,1,0,0,2009,1580,0,38,0
8, ARTVİN,73,0,0,0,7,0,0,0,2009,73,0,7,0
9, AYDIN,1102,83,2,0,15,0,0,0,2009,1185,2,15,0
10, BALIKESİR,928,121,1,0,42,0,0,0,2009,1049,1,42,0
11, BİLECİK,1020,50,1,0,3,0,0,0,2009,1070,1,3,0
12, BİNGÖL,20,0,0,0,2,0,0,0,2009,20,0,2,0
13, BİTLİS,21,0,0,0,5,0,0,0,2009,21,0,5,0
14, BOLU,496,43,0,0,6,0,0,0,2009,539,0,6,0
15, BURDUR,109,2,0,0,3,0,0,0,2009,111,0,3,0
16, BURSA,6828,752,4,0,42,0,0,0,2009,7580,4,42,0
17, ÇANAKKALE,286,25,0,0,6,0,0,0,2009,311,0,6,0
18, ÇANKIRI,31,2,1,0,1,0,0,0,2009,33,1,1,0
19, ÇORUM,141,5,0,0,8,0,0,0,2009,146,0,8,0
20, DENİZLİ,1957,227,0,2,18,0,0,0,2009,2184,2,18,0
21, DİYARBAKIR,115,4,0,0,15,0,0,0,2009,119,0,15,0
22, EDİRNE,166,36,0,0,6,0,0,0,2009,202,0,6,0
23, ELAZIĞ,231,5,0,0,16,0,0,0,2009,236,0,16,0
24, ERZİNCAN,49,1,0,0,2,0,0,0,2009,50,0,2,0
25, ERZURUM,73,1,0,0,9,0,0,0,2009,74,0,9,0
26, ESKİŞEHİR,2006,105,1,0,7,0,0,0,2009,2111,1,7,0
27, GAZİANTEP,500,5,0,0,26,1,0,0,2009,505,0,27,0
28, GİRESUN,75,5,0,0,3,0,0,0,2009,80,0,3,0
29, GÜMÜŞHANE,18,0,0,0,1,0,0,0,2009,18,0,1,0
30, HAKKARİ,2,0,0,0,6,0,0,0,2009,2,0,6,0
31, HATAY,728,5,0,0,31,0,0,0,2009,733,0,31,0
32, ISPARTA,100,4,0,0,7,0,0,0,2009,104,0,7,0
33, MERSİN,575,18,0,0,31,1,0,0,2009,593,0,32,0
34, İSTANBUL,7394,597,25,2,298,10,1,0,2009,7991,27,308,1
35, İZMİR,7438,504,150,8,78,0,0,0,2009,7942,158,78,0
36, KARS,15,0,0,0,3,0,0,0,2009,15,0,3,0
37, KASTAMONU,62,0,0,0,5,0,0,0,2009,62,0,5,0
38, KAYSERİ,201,2,0,0,29,0,0,0,2009,203,0,29,0
39, KIRKLARELİ,418,80,1,0,1,0,0,0,2009,498,1,1,0
40, KIRŞEHİR,144,0,0,0,2,0,0,0,2009,144,0,2,0
41, KOCAELİ,3082,121,23,0,51,1,0,0,2009,3203,23,52,0
42, KONYA,621,17,8,0,44,0,0,0,2009,638,8,44,0
43, KÜTAHYA,730,18,0,0,11,1,0,0,2009,748,0,12,0
44, MALATYA,189,6,0,0,11,0,0,0,2009,195,0,11,0
45, MANİSA,5302,302,20,0,35,1,0,0,2009,5604,20,36,0
46, K.MARAŞ,321,5,0,0,8,0,0,0,2009,326,0,8,0
47, MARDİN,0,0,0,0,15,0,0,0,2009,0,0,15,0
48, MUĞLA,459,36,0,0,10,0,0,0,2009,495,0,10,0
49, MUŞ,9,0,0,0,1,0,0,0,2009,9,0,1,0
50, NEVŞEHİR,34,3,0,0,13,1,0,0,2009,37,0,14,0
51, NİĞDE,58,1,0,0,2,0,0,0,2009,59,0,2,0
52, ORDU,154,12,0,0,12,0,0,0,2009,166,0,12,0
53, RİZE,92,0,0,0,2,0,0,0,2009,92,0,2,0
54, SAKARYA,38,0,0,0,14,0,0,0,2009,38,0,14,0
55, SAMSUN,492,16,1,0,12,0,0,0,2009,508,1,12,0
56, SİİRT,40,0,0,0,4,0,0,0,2009,40,0,4,0
57, SİNOP,88,2,0,0,3,0,0,0,2009,90,0,3,0
58, SİVAS,245,3,0,0,6,0,1,0,2009,248,0,6,1
59, TEKİRDAĞ,629,101,0,0,15,0,0,0,2009,730,0,15,0
60, TOKAT,142,1,0,0,11,0,0,0,2009,143,0,11,0
61, TRABZON,284,10,0,0,10,0,0,0,2009,294,0,10,0
62, TUNCELİ,22,0,0,0,3,0,0,0,2009,22,0,3,0
63, ŞANLIURFA,38,0,0,0,11,2,0,0,2009,38,0,13,0
64, UŞAK,375,28,0,0,7,0,0,0,2009,403,0,7,0
65, VAN,30,0,0,0,21,0,0,0,2009,30,0,21,0
66, YOZGAT,0,0,0,0,11,0,0,0,2009,0,0,11,0
67, ZONGULDAK,4598,32,89,0,63,0,6,0,2009,4630,89,63,6
68, AKSARAY,63,0,0,0,8,0,0,0,2009,63,0,8,0
69, BAYBURT,0,0,0,0,0,0,0,0,2009,0,0,0,0
70, KARAMAN,215,39,0,0,10,0,0,0,2009,254,0,10,0
71, KIRIKKALE,95,0,1,0,0,0,0,0,2009,95,1,0,0
72, BATMAN,49,0,0,0,9,0,0,0,2009,49,0,9,0
73, ŞIRNAK,39,0,0,0,15,0,0,0,2009,39,0,15,0
74, BARTIN,454,9,0,0,2,1,0,0,2009,463,0,3,0
75, ARDAHAN,0,0,0,0,1,0,0,0,2009,0,0,1,0
76, IĞDIR,0,0,0,0,6,0,0,0,2009,0,0,6,0
77, YALOVA,101,17,0,0,7,1,0,0,2009,118,0,8,0
78, KARABÜK,1049,7,1,0,2,0,0,0,2009,1056,1,2,0
79, KİLİS,14,2,0,0,0,0,0,0,2009,16,0,0,0
80, OSMANİYE,199,5,0,0,4,0,0,0,2009,204,0,4,0
81, DÜZCE,233,12,0,0,3,0,0,0,2009,245,0,3,0
1, ADANA,22,920,0,0,1,21,0,0,2008,942,0,22,0
2, ADIYAMAN,21,80,0,0,0,4,0,0,2008,101,0,4,0
3,AFYON,3,179,0,0,0,7,0,0,2008,182,0,7,0
4, AĞRI,0,5,0,0,0,1,0,0,2008,5,0,1,0
5, AMASYA,1,385,0,0,0,5,0,0,2008,386,0,5,0
6, ANKARA,133,3339,0,12,2,77,0,0,2008,3472,12,79,0
7, ANTALYA,218,1541,0,0,0,45,0,0,2008,1759,0,45,0
8, ARTVİN,0,77,0,0,0,2,0,0,2008,77,0,2,0
9, AYDIN,96,1461,0,2,0,7,0,0,2008,1557,2,7,0
10, BALIKESİR,100,987,0,1,0,9,0,0,2008,1087,1,9,0
11, BİLECİK,42,1043,0,1,0,3,0,0,2008,1085,1,3,0
12, BİNGÖL,0,15,0,0,0,0,0,0,2008,15,0,0,0
13, BİTLİS,0,11,0,0,0,0,0,0,2008,11,0,0,0
14, BOLU,36,343,0,0,0,7,0,0,2008,379,0,7,0
15, BURDUR,6,90,0,0,0,1,0,0,2008,96,0,1,0
16, BURSA,530,6620,0,2,1,41,0,0,2008,7150,2,42,0
17, ÇANAKKALE,31,412,0,0,1,9,0,0,2008,443,0,10,0
18, ÇANKIRI,2,56,0,3,0,0,0,0,2008,58,3,0,0
19, ÇORUM,3,136,0,0,0,3,0,0,2008,139,0,3,0
20, DENİZLİ,225,2173,0,1,0,26,0,0,2008,2398,1,26,0
21, DİYARBAKIR,4,107,0,0,0,18,0,0,2008,111,0,18,0
22, EDİRNE,11,122,0,0,0,11,0,0,2008,133,0,11,0
23, ELAZIĞ,0,252,0,0,1,9,0,0,2008,252,0,10,0
24, ERZİNCAN,1,37,0,2,0,0,0,0,2008,38,2,0,0
25, ERZURUM,0,91,0,0,0,5,0,0,2008,91,0,5,0
26, ESKİŞEHİR,97,2225,0,1,0,9,0,0,2008,2322,1,9,0
27, GAZİANTEP,17,794,0,0,1,20,0,0,2008,811,0,21,0
28, GİRESUN,3,42,0,0,0,5,0,0,2008,45,0,5,0
29, GÜMÜŞHANE,0,25,0,0,0,6,0,0,2008,25,0,6,0
30, HAKKARİ,0,10,0,0,0,2,0,0,2008,10,0,2,0
31, HATAY,5,1038,0,0,0,17,0,0,2008,1043,0,17,0
32, ISPARTA,7,80,0,0,0,0,0,0,2008,87,0,0,0
33, MERSİN,14,787,0,1,0,32,0,0,2008,801,1,32,0
34, İSTANBUL,459,8030,2,23,4,135,0,0,2008,8489,25,139,0
35, İZMİR,547,9548,9,78,2,50,0,0,2008,10095,87,52,0
36, KARS,0,17,0,0,0,1,0,0,2008,17,0,1,0
37, KASTAMONU,0,73,0,0,0,1,0,0,2008,73,0,1,0
38, KAYSERİ,52,2727,0,0,1,11,0,0,2008,2779,0,12,0
39, KIRKLARELİ,70,388,0,0,0,7,0,0,2008,458,0,7,0
40, KIRŞEHİR,0,83,0,0,0,5,0,0,2008,83,0,5,0
41, KOCAELİ,112,3489,0,1,0,23,0,0,2008,3601,1,23,0
42, KONYA,10,926,1,1,0,19,0,0,2008,936,2,19,0
43, KÜTAHYA,21,1166,0,1,0,4,0,0,2008,1187,1,4,0
44, MALATYA,3,135,0,0,0,4,0,0,2008,138,0,4,0
45, MANİSA,255,5890,0,6,0,9,0,0,2008,6145,6,9,0
46, K.MARAŞ,0,181,0,0,0,8,0,0,2008,181,0,8,0
47, MARDİN,4,13,0,0,0,9,0,0,2008,17,0,9,0
48, MUĞLA,42,647,0,0,0,8,0,0,2008,689,0,8,0
49, MUŞ,0,1,0,0,0,0,0,0,2008,1,0,0,0
50, NEVŞEHİR,2,68,0,0,0,4,0,0,2008,70,0,4,0
51, NİĞDE,0,58,0,0,0,4,0,0,2008,58,0,4,0
52, ORDU,5,84,0,1,0,3,0,0,2008,89,1,3,0
53, RİZE,2,91,0,0,0,6,0,0,2008,93,0,6,0
54, SAKARYA,21,718,2,28,0,13,0,0,2008,739,30,13,0
55, SAMSUN,10,592,0,3,0,13,0,0,2008,602,3,13,0
56, SİİRT,0,7,0,0,0,2,0,0,2008,7,0,2,0
57, SİNOP,7,63,0,0,0,2,0,0,2008,70,0,2,0
58, SİVAS,0,293,0,0,0,5,0,0,2008,293,0,5,0
59, TEKİRDAĞ,177,1277,0,2,1,11,0,0,2008,1454,2,12,0
60, TOKAT,6,130,0,0,0,3,0,0,2008,136,0,3,0
61, TRABZON,14,314,0,1,0,16,0,1,2008,328,1,16,1
62, TUNCELİ,0,10,0,0,0,0,0,0,2008,10,0,0,0
63, ŞANLIURFA,0,40,0,0,0,7,0,0,2008,40,0,7,0
64, UŞAK,38,504,0,1,0,6,0,0,2008,542,1,6,0
65, VAN,0,8,0,0,0,3,0,0,2008,8,0,3,0
66, YOZGAT,1,70,0,0,0,3,0,0,2008,71,0,3,0
67, ZONGULDAK,38,3643,0,353,0,20,0,0,2008,3681,353,20,0
68, AKSARAY,2,76,0,0,0,6,0,0,2008,78,0,6,0
69, BAYBURT,0,17,0,0,0,0,0,0,2008,17,0,0,0
70, KARAMAN,23,169,0,0,0,2,0,0,2008,192,0,2,0
71, KIRIKKALE,1,176,0,0,0,4,0,0,2008,177,0,4,0
72, BATMAN,0,12,0,0,0,3,0,0,2008,12,0,3,0
73, ŞIRNAK,0,9,0,0,0,4,0,0,2008,9,0,4,0
74, BARTIN,4,205,0,0,0,2,0,0,2008,209,0,2,0
75, ARDAHAN,0,0,0,0,0,0,0,0,2008,0,0,0,0
76, IĞDIR,0,7,0,0,0,4,0,0,2008,7,0,4,0
77, YALOVA,11,230,0,0,0,3,0,0,2008,241,0,3,0
78, KARABÜK,6,1184,0,0,0,3,0,0,2008,1190,0,3,0
79, KİLİS,0,2,0,0,0,0,0,0,2008,2,0,0,0
80, OSMANİYE,0,3,0,0,0,0,0,0,2008,3,0,0,0
81, DÜZCE,23,512,0,0,0,0,0,0,2008,535,0,0,0
1, ADANA,26,1140,0,0,0,42,0,0,2007,1166,0,42,0
2, ADIYAMAN,60,96,0,0,0,3,0,0,2007,156,0,3,0
3,AFYON,3,157,0,0,0,5,0,0,2007,160,0,5,0
4, AĞRI,0,0,0,0,0,3,0,0,2007,0,0,3,0
5, AMASYA,2,407,0,0,0,4,0,0,2007,409,0,4,0
6, ANKARA,119,3450,0,17,0,85,0,0,2007,3569,17,85,0
7, ANTALYA,172,1347,0,0,2,46,0,0,2007,1519,0,48,0
8, ARTVİN,0,42,0,0,0,3,0,0,2007,42,0,3,0
9, AYDIN,140,1534,2,5,0,13,0,0,2007,1674,7,13,0
10, BALIKESİR,120,1100,0,1,0,30,0,0,2007,1220,1,30,0
11, BİLECİK,90,1512,0,1,0,7,0,0,2007,1602,1,7,0
12, BİNGÖL,0,16,0,0,0,1,0,0,2007,16,0,1,0
13, BİTLİS,0,1,0,0,0,1,0,0,2007,1,0,1,0
14, BOLU,37,436,0,0,0,5,0,0,2007,473,0,5,0
15, BURDUR,2,81,0,0,0,3,0,0,2007,83,0,3,0
16, BURSA,675,7719,0,1,2,52,0,0,2007,8394,1,54,0
17, ÇANAKKALE,27,473,0,0,0,5,0,0,2007,500,0,5,0
18, ÇANKIRI,0,35,0,3,0,2,0,0,2007,35,3,2,0
19, ÇORUM,4,213,0,0,1,7,0,0,2007,217,0,8,0
20, DENİZLİ,205,2079,2,1,1,11,0,0,2007,2284,3,12,0
21, DİYARBAKIR,1,120,0,0,0,18,0,0,2007,121,0,18,0
22, EDİRNE,9,122,0,2,0,6,0,0,2007,131,2,6,0
23, ELAZIĞ,2,184,0,0,0,7,0,0,2007,186,0,7,0
24, ERZİNCAN,4,65,0,0,0,2,0,0,2007,69,0,2,0
25, ERZURUM,1,106,0,0,0,8,0,0,2007,107,0,8,0
26, ESKİŞEHİR,86,2054,0,2,1,12,0,0,2007,2140,2,13,0
27, GAZİANTEP,15,725,0,1,0,30,0,0,2007,740,1,30,0
28, GİRESUN,1,25,0,0,0,1,0,0,2007,26,0,1,0
29, GÜMÜŞHANE,0,31,0,0,0,0,0,0,2007,31,0,0,0
30, HAKKARİ,0,1,0,0,0,1,0,0,2007,1,0,1,0
31, HATAY,4,1240,0,0,0,30,0,0,2007,1244,0,30,0
32, ISPARTA,8,113,0,0,0,5,0,0,2007,121,0,5,0
33, MERSİN,19,640,0,0,0,29,0,0,2007,659,0,29,0
34, İSTANBUL,522,9675,1,22,3,167,0,0,2007,10197,23,170,0
35, İZMİR,552,9280,6,101,1,32,0,0,2007,9832,107,33,0
36, KARS,0,17,0,0,0,5,0,0,2007,17,0,5,0
37, KASTAMONU,2,50,0,0,1,3,0,0,2007,52,0,4,0
38, KAYSERİ,40,2947,0,0,0,25,0,0,2007,2987,0,25,0
39, KIRKLARELİ,100,735,0,0,0,7,0,0,2007,835,0,7,0
40, KIRŞEHİR,0,91,0,0,0,1,0,0,2007,91,0,1,0
41, KOCAELİ,234,7298,0,16,0,41,0,1,2007,7532,16,41,1
42, KONYA,11,835,0,5,0,25,0,0,2007,846,5,25,0
43, KÜTAHYA,13,860,0,2,0,11,0,0,2007,873,2,11,0
44, MALATYA,1,162,0,0,0,8,0,0,2007,163,0,8,0
45, MANİSA,277,4796,0,15,0,15,0,0,2007,5073,15,15,0
46, K.MARAŞ,9,282,0,0,0,13,0,0,2007,291,0,13,0
47, MARDİN,0,10,0,0,0,5,0,0,2007,10,0,5,0
48, MUĞLA,41,720,0,0,0,19,0,0,2007,761,0,19,0
49, MUŞ,0,3,0,0,0,0,0,0,2007,3,0,0,0
50, NEVŞEHİR,2,65,0,0,0,5,0,0,2007,67,0,5,0
51, NİĞDE,2,68,0,0,0,3,0,0,2007,70,0,3,0
52, ORDU,3,83,0,0,0,9,0,0,2007,86,0,9,0
53, RİZE,2,73,0,0,0,6,0,0,2007,75,0,6,0
54, SAKARYA,27,921,0,5,0,10,0,0,2007,948,5,10,0
55, SAMSUN,5,677,0,0,0,14,0,0,2007,682,0,14,0
56, SİİRT,0,5,0,0,0,2,0,0,2007,5,0,2,0
57, SİNOP,13,68,0,0,0,1,0,0,2007,81,0,1,0
58, SİVAS,0,312,0,0,0,4,0,0,2007,312,0,4,0
59, TEKİRDAĞ,250,1556,0,0,2,18,0,0,2007,1806,0,20,0
60, TOKAT,0,129,0,0,0,2,0,0,2007,129,0,2,0
61, TRABZON,14,369,0,0,0,14,0,0,2007,383,0,14,0
62, TUNCELİ,0,10,0,0,0,2,0,0,2007,10,0,2,0
63, ŞANLIURFA,0,60,0,0,0,16,0,0,2007,60,0,16,0
64, UŞAK,48,617,0,0,0,8,0,0,2007,665,0,8,0
65, VAN,0,15,0,0,0,10,0,0,2007,15,0,10,0
66, YOZGAT,0,64,0,0,0,6,0,0,2007,64,0,6,0
67, ZONGULDAK,48,3746,0,996,0,10,0,0,2007,3794,996,10,0
68, AKSARAY,6,62,0,0,0,7,0,0,2007,68,0,7,0
69, BAYBURT,0,8,0,0,0,2,0,0,2007,8,0,2,0
70, KARAMAN,26,246,0,0,0,9,0,0,2007,272,0,9,0
71, KIRIKKALE,2,116,0,0,0,4,0,0,2007,118,0,4,0
72, BATMAN,0,28,0,0,0,1,0,0,2007,28,0,1,0
73, ŞIRNAK,0,4,0,0,0,2,0,0,2007,4,0,2,0
74, BARTIN,5,244,0,1,0,0,0,0,2007,249,1,0,0
75, ARDAHAN,0,0,0,0,0,0,0,0,2007,0,0,0,0
76, IĞDIR,0,0,0,0,0,2,0,0,2007,0,0,2,0
77, YALOVA,9,181,0,0,0,3,0,0,2007,190,0,3,0
78, KARABÜK,10,1258,0,0,0,4,0,0,2007,1268,0,4,0
79, KİLİS,0,6,0,0,0,0,0,0,2007,6,0,0,0
80, OSMANİYE,0,32,0,0,0,0,0,0,2007,32,0,0,0
81, DÜZCE,15,433,0,0,0,0,0,0,2007,448,0,0,0
0,0,0,0,0,0,0,1,0,0,2007,0,0,1,0
